34343434343434343434343434343434343434343434361D9E1B343434343434343434343
434343434343434343434343434343434343434343434C1D9E12B34343434343434343434
34343434343434343434343434343434343434343434C21D9E121B3434343434343434343
4343434343434343434343434343434343434343434CA21D9E1211B343434343434343434
343434343434343434343434343434343434343434CA221D9E12111BCB343434CB3434343
43434343434343434343434343434343434343434CA2211D9E12211111B3434CAAB343434
3434343434343434343434343434343434343434CA22117H9E112111111B34CAA2AB34343
434343434343434343434343434343434343434CA22111H99G1122111111BCA222AAB3434
34343434343434CBCB34343434343434343434CA22117H9KG11222211112AA21112AAB343
4343434343434CAAAAB34343434343434CBCBC2A2111H9KG1122AA22111122111112AABCB
343434343434CAAAAAAB3434343434CBCA211112217H9K11122AAAA222111122211122AAA
434343434CBCAAAAAAAAB343434CBCAAAA21781211D9KG11222AA56AAA2222AA222111222
343434343622AAA2AAAAAB3434CAAA222221FG1111FL111222AA543656A2AA56AAA211111
434343434C2222222AAAAABCBCAA221111111117811111222AA54343436AA543656A22211
34343434361222222AAAAAAAAAA222221781121FG122222AAA543434343654343436AAA22
434343434C112222222AAAAAAAAAAAA21FG12211112AAAAAA5434343434343434343656AA
34343434361112212222AAAA56AA565611112A22565656565434343434343434343434365
434343434C11112122AAAAA54365434365656AA5434343434343434343434343434343434
34343434361112212AAAAA543434343434343654343434343434343434343434343434343
434343434C1122222AAAA5434343434343434343434343434343434343434343434343434
3434343436122222AAAA54343434343434343434343434343434343434343434343434343
434343434C222222AAAAB3434343434343434343434CBCBCBCB3434343434343434343434
3434343436222AA2AAAA5434343434343434343434CAAAAAAAAB343434343434343434343
4343434343622AAAAAA5434343434343434343434CAAAAAAAAAAB34343434343434343434
343434343436AAAAAA5434343434343434343434CAAAA2222AAAAB3434343434343434343
434343434343656AA5434343434343434343434CAAAA222222AAAAB343434343434343434
34343434343434365434343434343434343434CAAAA2222222AAAA5434343434343434343
4343434343434343434343434343434343434CAAAA22222222AAA54343434343434343434
343434343434343434343434343434343434CAAAA22222222AAA543434343434343434343
43434343434343434343434343434343434CAAAA222222222AA5434343434343434343434
343434343434343434343434343434343436AAA2222222AAAA54343434343434343434343
4343434343434343434343434343434343436AA222222AA56543434343434343434343434
