34343434343434343434343434343434343434343434361D9E1B343434343434343434343
434343434343434343434343434343434343434343434C1D9E12B34343434343434343434
34343434343434343434343434343434343434343434C21D9E12AB3434343434343434343
4343434343434343434343434343434343434343434CA21D9E12AAB343434343434343434
343434343434343434343434343434343434343434CAA21D9E122AABCB343434CB3434343
43434343434CBCB34343434343434343434343434CAAA21D9E122AAAAAB3434CAAB343434
34343434CBCAAAAB343434343434343434343434CAAAA21D9E1122AAAAAB34CAAAAB34343
4343434CAAAAAAAAB3434343434343434343434CAAAA221D9I8112222AAABCAAAAAAB3434
343434CAAAAAAAAAAB34343434343434343434CAAAA2221FJ9I811112222222AA22AAB343
43434CAAAA22AAAAAAB34343434343434CBCBCAAAA222211FJ9IMM81111111222222AABCB
3434CAAAA2222AAAAAAB3434343434CBCAAAAAAA222222111FJ999IMMMM81111222222222
4CBCAAAA222222AAAAAAB343434CBCAAAAAAAAA22222222211FLLJ99999IMM81111111111
36AAAAA222222222AAAAAB3434CAAAAAA22222222222222221111FLLLLJ999IMMMMMMMMMM
4CAAAA22211122222AAAAABCBCAAA22222222222222222222222111111FLLJ99999999999
36AAAA22111111222AAAAAAAAAAAAAAA222222222AAAA2222AA2222221111FLLLLLLLLLLL
4CAAA22211111112222AAAAAAAAAAAAAAAAA222AAAAAAAAAAAAAAAAA22221111111111111
36AAA221111111122222AAAA56AA5656AAAAAAAA565656565656AAAAAA222222211222222
4CAAA2211111111222AAAAA54365434365656AA543434343434365656AAA2222222AA5656
36AAA221111111122AAAAA543434343434343654343434343434343436AAAAAAAA5654343
4CAAA222211111222AAAA5434343434343434343434343434343434343656AA5654343434
36AAA22222111222AAAA54343434343434343434343434343434343434343654343434343
4CAAAA2222222222AAAAB3434343434343434343434CBCBCBCB3434343434343434343434
36AAAAA22222222AAAAA5434343434343434343434CAAAAAAAAB343434343434343434343
436AAAAAA22222AAAAA5434343434343434343434CAAAAAAAAAAB34343434343434343434
3436AAAAAAA2AAAAAA5434343434343434343434CAAAA2222AAAAB3434343434343434343
4343656AAAAAAAA565434343434343434343434CAAAA222222AAAAB343434343434343434
34343436AAAAAA543434343434343434343434CAAAA2222222AAAA5434343434343434343
4343434365656543434343434343434343434CAAAA22222222AAA54343434343434343434
343434343434343434343434343434343434CAAAA22222222AAA543434343434343434343
43434343434343434343434343434343434CAAAA222222222AA5434343434343434343434
343434343434343434343434343434343436AAA2222222AAAA54343434343434343434343
4343434343434343434343434343434343436AA222222AA56543434343434343434343434
