343434343434343434343434343434343434343434343GAAAAAB343434343434343434343
434343434343434343434343434343434343434343434CAAAAAAB34343434343434343434
34343434343434343434343434343434343434343434CAAAAAAAAB3434343434343434343
4343434343434343434343434343434343434343434CAAAAAAAAAAB343434343434343434
343434343434343434343434343434343434343434CAAAAAAAAAAAABCB343434CB3434343
43434343434CBCB34343434343434343434343434CAAAAAAAAAAAAAAAAB3434CAAB343434
34343434CBCAAAAB343434343434343434343434CAAAAAAAAAAAAAAAAAAB34CAAAABCB343
4343434CAAAAAAAAB3434343434343434343434CAAAAAAAAAAAAAAAAAAAABCAAAAAAAAB34
343434CAAAAAAAAAAB34343434343434343434CAAAAAAAAAAAAAAAAAAAAAAAAAAAAAAAAB3
43434CAAAAAAAAAAAAB34343434343434CBCBCAAAAAAAAAAAAAAAAAAAAAAAAAAAAAAAAAAB
3434CAAAAAAAAAAAAAAB3434343434CBCAAAAAAAAAAAAAAAAAAAAAAAAAAAAAAAAAAAAAAAA
4CBCAAAAAAAAAAAAAAAAB343434CBCAAAAAAAAAAAAAAAAAAAAAAAAAAAAAAAAAAAAAAAAAAA
36AAAAAAAAAAAAAAAAAAAB3434CAAAAAAAAAAAAAAAAAAAAAAAAAAAAAAAAAAAAAAAAAAAAAA
4CAAAAAAAAAAAAAAAAAAAABCBCAAAAAAAAAAAAAAAAAAAAAAAAAAAAAAAAAAAAAAAAAAAAAAA
36AAAAAAAAAAAAAAAAAAAAAAAAAAAAAAAAAAAAAAAAAAAAAAAAAAAAAAAAAAAAAAAAAAAAAAA
4CAAAAAAAAAAAAAAAAAAAAAAAAAAAAAAAAAAAAAAAAAAAAAAAAAAAAAAAAAAAAAAAAAAAAAAA
36AAAAAAAAAAAAAAAAAAAAAA56AA5656AAAAAAAA565656565656AAAAAAAAAAAAAAAAAAAAA
4CAAAAAAAAAAAAAAAAAAAAA54365434365656AA543434343434365656AAAAAAAAAAAA5656
36AAAAAAAAAAAAAAAAAAAA543434343434343654343434343434343436AAAAAAAA5654343
4CAAAAAAAAAAAAAAAAAAA5434343434343434343434343434343434343656AA5654343434
36AAAAAAAAAAAAAAAAAA54343434343434343434343434343434343434343654343434343
4CAAAAAAAAAAAAAAAAAAB3434343434343434343434CBCBCBCB3434343434343434343434
36AAAAAAAAAAAAAAAAAA5434343434343434343434CAAAAAAAAB343434343434343434343
436AAAAAAAAAAAAAAAA5434343434343434343434CAAAAAAAAAAB34343434343434343434
3436AAAAAAAAAAAAAA5434343434343434343434CAAAAAAAAAAAAB3434343434343434343
4343656AAAAAAAA565434343434343434343434CAAAAAAAAAAAAAAB343434343434343434
34343436AAAAAA543434343434343434343434CAAAAAAAAAAAAAAA5434343434343434343
4343434365656543434343434343434343434CAAAAAAAAAAAAAAA54343434343434343434
343434343434343434343434343434343434CAAAAAAAAAAAAAAA543431122334455667788
43434343434343434343434343434343434CAAAAAAAAAAAAAAA5434341122334455667788
343434343434343434343434343434343436AAAAAAAAAAAAAA543434399AABBCCDDEEFFGG
4343434343434343434343434343434343436AAAAAAAAAA565434343499AABBCCDDEEFFGG
