3434343434343434343434343434343434343434343434343434343434343434343434343434343434343434343434343434
4343434343434343434343434343434343434343434343434343434343434343434343434343434343434343434343434343
3434343434343434343434343434343434343434343434343434343434343434343434343434343434343434343434343434
4343434343434343434343434343434343434343434343434343434343434343434343434343434343434343434343434343
3434343434343434343434343434343434343434343434343434343434343434343434343434343434343434343434343434
4343434343434343434343434343434343434343434343434343434343434343434343434343434343434343434343434343
3434343434343434343434343434343434343434343434343434343434343434343434343434343434343434343434343434
4343434343434343434343434343434343434343434343434343434343434343434343434343434343434343434343434343
3434343434343434343434343434343434343434343434343434343434343434343434343434343434343434343434343434
4343434343434343434343434343434343434343434343434343434343434343434343434343434343434343434343434343
3434343434343434343434343434343434343434343434343434343434343434343434343434343434343434343434343434
4343434343434343434343434343434343434343434343434343434343434343434343434343434343434343434343434343
3434343434343434343434343434343434343434343434343434343434343434343434343434343434343434343434343434
4343434343434343434343434343434343434343434343434343434343434343434343434343434343434343434343434343
3434343434343434343434343434343434343434343434343434343434343434343434343434343434343434343434343434
4343434343434343434343434343434343434343434343434343434343434343434343434343434343434343434343434343
3434343434343434343434343434343434343434343434343434343434343434343434343434343434343434343434343434
4343434343434343434343434343434343434343434343434343434343434343434343434343434343434343434343434343
3434343434343434343434343434343434343434343434343434343434343434343434343434343434343434343434343434
4343434343434343434343434343434AAAAAAAA3434343434343434343434343434343434343434343434343434343434343
3434343434343434343434343434343AAAAAAAA43434343434343434343434343434343434AAAA3434343434343434343434
4343434343434343434343434343434AAAAAAAA3434343434343434343434343434343434AAAAAA343434343434343434343
3434343434343434343434343434343AAAAAAAA43434343434343434343434343434343AAAAAAAAAAA343434343434343434
4343434343434343434343434343434AAAAAAAA3434343434343434343434343434343AAAAAAAAAAAAA34343434343434343
3434343434343434343434343434343AAAAAAAAA3434343434AAA4343434343434343AAAAAAAAAAAAAAAA434343434343434
4343434343434343434343434343434AAAAAAAAA434343434AAAAAA3434343434343AAAAAA434AAAAAAAA343434343434343
343434343434343434343434343434AAAAAAAAAA3434343AAAAAAAAA343434343434AAAAA4343434AAAAA434343434343434
434343434343434343434343434343AAAAAAAAAA434343AAAAAAAAAAAAAAA3434343AAAA43434343AAAAAA43434343434343
343434343434343434343434343434AAAAAAAAAA34343AAAAAAAAAAAAAAAAAAAA434AAAA343434343AAAAA34343434343434
434343434343434343434343434343AAAAAAAAAA43434AAAAAAAAAAAAAAAAAAAAAAAAAAAAA4343434AAAAA43434343434343
343434343434343434343434343434AAAAAAAAAA34343AAAAAAAAAAAAAAAAAAAAAAAAAAAAAAA343434AAAA34343434343434
434343434343434343434343434343AAAAAAAAAA4343434AAAAAAAAAAAAAAAAAAAAAAAAAAAAAA34343AAAA43434343434343
343434343434343434343434343434AAAAAAAAAA343434343AAAAAAAAAAAAAAAAA343434AAAAAA3434343434343434343434
434343434343434343434343434343AAAAAAAAAA43434343434AAAAAAAAAAAAA434343434AAAAAA343434343434343434343
343434343434343434343434343434AAAAAAAAAA3434343434343AAAAAAAAAA43434343434AAAAA434343434343434343434
434343434343434343434343434343AAAAAAAAAA43434343434343434AAAAAAA43434343434AAAAA43434343434343434343
3434343434343434343434343434343AAAAAAAAA3434343434343434343AAAAAA43434343434AAAA34343434343434343434
4343434343434343434343434343434AAAAAAAA343434343434343434343AAAAAA4343434343AAAA43434343434343434343
3434343434343434343434343434343AAAAAAAA4343434343434343434343AAAAAA43434343AAAA434343434343434343434
43434343434343434343434343434343AAAAAA434343434343434343434343AAAA43434343AAAAA343434343434343434343
343434343434343434343434343434343AAAA43434343434343434343434343AA43434343AAAAA3434343434343434343434
434343434343434343434343434343434AAAA34343434343434343434343434343434343AAAAAA4343434343434343434343
343434343434343434343434343434343AAAA4343434343434343434343434343434343AAAAAA43434343434343434343434
434343434343434343434343434343434AAAA343434343434343434343434343434343AAAAAAA34343434343434343434343
343434343434343434343434343434343AAAA434343434343434343434343434343434AAAAAAA43434343434343434343434
43434343434343434343434343434343AAAAA34343434343434343434343434343434AAAAAAAA34343434343434343434343
3434343434343434343434343434343AAAAAA4343434343434343434343434343434AAAAAAAAAA3434343434343434343434
43434343434343434343434343AAAAAAAAAA43434343434343434343434343434343AAAAAAAAAA4343434343434343434343
343434343434343434343434AAAAAAAAAAAA34343434343434343434343434343434AAAAAAAAAAA434343434343434343434
43434343434343434343AAAAAAAAAAAAAA4343434343434343434343434343434343AAAAAAAAAAA343434343434343434343
3434343434343434AAAAAAAAAAAAAAAAAA3434343434343434343434343434343434AAAAAAAAAA3434343434343434343434
4343434343434343AAAAAAAAAAAAAAAAAAA3434343434343434343434343434343434AAAAAAAAA4343434343434343434343
343434343434343AAAAAAAAAAA34343AAAAAA4343434343434343434343434343434343AAAAAAA3434343434343434343434
434343434343434AAAA34343434343434AAAA3434343434343434343434343434343434343AAA34343434343434343434343
343434343434343AAAA43434343434343AAAA4343434343434343434343434343434343434AAA43434343434343434343434
