3434343434343434343434343434343434343434343434343434343434343434343434343434343434343434343434343434
4343434343434343434343434343434343434343434343434343434343434343434343434343434343434343434343434343
3434343434343434343434343434343434343434343434343434343434343434343434343434343434343434343434343434
4343434343434343434343434343434343434343434343434343434343434343434343434343434343434343434343434343
3434343434343434343434343434343434343434343434343434343434343434343434343434343434343434343434343434
4343434343434343434343434343434343434343434343434343434343434343434343434343434343434343434343434343
3434343434343434343434343434343434343434343434343434343434343434343434343434343434343434343434343434
4343434343434343434343434343434343434343434343434343434343434343434343434343434343434343434343434343
3434343434343434343434343434343434343434343434343434343434343434343434343434343434343434343434343434
4343434343434343434343434343434343434343434343434343434343434343434343434343434343434343434343434343
3434343434343434343434343434343434343434343434343434343434343434343434343434343434343434343434343434
4343434343434343434343434343434343434343434343434343434343434343434343434343434343434343434343434343
3434343434343434343434343434343434343434343434343434343434343434343434343434343434343434343434343434
4343434343434343434343434343434343434343434343434343434343434343434343434343434343434343434343434343
3434343434343434343434343434343434343434343434343434343434343434343434343434343434343434343434343434
4343434343434343434343434343434343434343434343434343434343434343434343434343434343434343434343434343
3434343434343434343434343434343434343434343434343434343434343434343434343434343434343434343434343434
4343434343434343434343434343434343434343434343434343434343434343434343434343434343434343434343434343
34343434343434343434343434343434CBCBCB34343434343434343434343434343434343434343434343434343434343434
4343434343434343434343434343434CAAAAAAB343434343434343434343434343434343434CB34343434343434343434343
343434343434343434343434343434CA2222AAAB3434343434343434343434343434343434CAAB3434343434343434343434
4343434343434343434343434343436A222222A54343434343434343434343434343434CBCAAAABCB3434343434343434343
343434343434343434343434343434CA211222AB343434343434343434343434343434CAAA22222AAB343434343434343434
4343434343434343434343434343436A211222A543434343434CB3434343434343434CA222222222AABCB343434343434343
343434343434343434343434343434CA211122AB3434343434CAAB34343434343434CA222AAAAA2222AAAB34343434343434
4343434343434343434343434343436A2111222AB343434CBCAAAAB343434343434CAA22A5656AAA2222A543434343434343
343434343434343434343434343434CA2111122A543434CAAAA22AABCBCB34343436AAAA54343656AA22AB34343434343434
43434343434343434343434343434CAA2111122AB3434CAA222222AAAAAABCBCB34CAAA5434343436A222AB3434343434343
343434343434343434343434343436A22111112A5434CA2221111222222AAAAAABCA22ABCB343434CA222A54343434343434
43434343434343434343434343434CA22111112AB3436A222111111112222222AAAA222AAAB343436A222AB3434343434343
343434343434343434343434343436A21111112A543436AA22222111111111122222222222AB343436A22A54343434343434
43434343434343434343434343434CA22111112AB343436AAAA221111111222222AAAAAA222AB343436AA543434343434343
343434343434343434343434343436A22111122A5434343656AA2221111112AAAA565656A222AB3434365434343434343434
43434343434343434343434343434CA22111122AB3434343436AAA22222212A5654343436A222AB343434343434343434343
343434343434343434343434343436AA2211122A54343434343656AAAA2222AB3434343436A222AB34343434343434343434
4343434343434343434343434343436A2211222AB3434343434343656AAA222AB3434343436A222AB3434343434343434343
343434343434343434343434343434CA2221222A54343434343434343656A22AAB3434343436A22A54343434343434343434
4343434343434343434343434343436A22212AA5434343434343434343436AA2AAB34343434C22A543434343434343434343
34343434343434343434343434343436AA22AA543434343434343434343436AAAA54343434CA22AB34343434343434343434
434343434343434343434343434343436A22A54343434343434343434343436AA54343434CAA2AA543434343434343434343
34343434343434343434343434343434CA22AB3434343434343434343434343654343434CAA2AA5434343434343434343434
434343434343434343434343434343436A22A5434343434343434343434343434343434CAA22A54343434343434343434343
34343434343434343434343434343434CA22AB34343434343434343434343434343434CAAA22AB3434343434343434343434
434343434343434343434343434343436A22A54343434343434343434343434343434CAAA222A54343434343434343434343
34343434343434343434343434343434CA22AB34343434343434343434343434343436AA2222AB3434343434343434343434
4343434343434343434343434343434CAA22A54343434343434343434343434343434CAA2212A54343434343434343434343
34343434343434343434343434CBCBCAA22A54343434343434343434343434343434CAA22212AB3434343434343434343434
4343434343434343434343434CAAAAAA222AB343434343434343434343434343434CAA222112AAB343434343434343434343
34343434343434343434CBCBCA22222222AA54343434343434343434343434343436A22111122AAB34343434343434343434
43434343434343434CBCAAAAA222211122A54343434343434343434343434343434CA22211122AA543434343434343434343
3434343434343434CAAA22222222222222AB34343434343434343434343434343436AA2222222A5434343434343434343434
434343434343434CA222222222AAAAAA222AB34343434343434343434343434343436AAAAAA22AB343434343434343434343
34343434343434CAA2222AAAAA565656A222AB343434343434343434343434343434365656AAAA5434343434343434343434
434343434343436A22A56565654343436A22A543434343434343434343434343434343434CAAA54343434343434343434343
34343434343434CA22AB343434343434CA22AB343434343434343434343434343434343436AAAB3434343434343434343434
