343434343434343434343434343434343434343AAAA434343434343434AAAA343434343434343434343434343434343434AAA4343434343434343AAAAAAA
434343434343434343434343434343434343434AAAA343434343434343AAAA434AAA434343434343434343434343434343AAA3434343434343434AAAAAAA
34343434343434343434343434343434343AAAAAAAAAAA343434343434AAAAAAAAAA3434343434343434343434343434AAAAAA343434343434343AAAAAAA
43434343434343434343434343434343434AAAAAAAAAAA4343434343434AAAAAAAAA4343434343434AAAAA434343434AAAAAAAA343434343434343AAAAAA
3434343434343434343434343434343434AAAAAAAAAAAA34343434343434AAAAAA343434343AAAAAAAAAAAAAA4343AAAAAAAAAAA343434343434343AAAAA
434343434343434343434343434343434AAAAAAAAAAAAA4343434343434343434343434AAAAAAAAAAAAAAAAA43434AAAAAAAAAAAA343AA4343434343AAAA
343434343434343434343434343434343AAAAAAAAAAAAA34343434343434343434343AAAAAAAAAAAAAAAAAAA3434AAAAAAAAAAAAAAAAAAAA343434343AAA
434343434343434343434343434343434AAAAAAAAAAAAA43434343434343434AAAAAAAAAAAAAA34343434AAAAAAAAAAAAAAAAAAAAAAAAAAAAA4343434343
343434343434343434343434343434343AAAAAAAAAAAAA3434343434343AAAAAAAAAAAAAAAAA343434343AAAAAAAAAAAAAAAAAAAAAAAAAAAAAA434343434
434343434343434343434343434343434AAAAAAAAAAAAA43434343434AAAAAAAAAAAAAAAA343434343434AAAAAAAAAAAAAAAAAA34AAAAAAAAAAA43434343
3434343434343434343434343434343434AAAAAAAAAAA434343434343AAAAAAAAAAAA4343434343434343AAA3434AAAAAAAAAAA4343434AAAAAA34343434
4343434343434343434343434343434343AAAAAAAAAA434343434343AAAAAAAA43434343434343A343434AAA4343AAAAAAAAAA434343434AAAAAA3434343
34343434343434343434343434343434343AAAAAAAAA3434343434AAAAAA3434343434343434AAAA34343AAAA434343AAAAA343434343434AAAAAA343434
434343434343434343434343434343434343AAAAAA434343434343AAAAA3434343434343AAAAAAAA43434AAAA3434343434343434AAA43434AAAAA434343
3434343434343434343434343434343434343AAAAA343434343434AAAAA4343434AAAAAAAAAAAAA434343AAAA4343434343434343AAAA43434AAAAA43434
43434343434343434343434343434343434343AAAA434343434343AAAAA3434AAAAAAAAAAAAAAAA343434AAAA3434343434343434AAAA343434AAAA34343
34343434343434343434343434343434343434AAAAAAAA343434343AAAAA343AAAAAAAAAAAAAAA343434AAAAA43434343434343434AAAA34343AAAA43434
43434343434343434343434343434343434343AAAAAAAAAA43434343AAAA4343AAAAAA4343AAAA434343AAAAAAA343434343434343AAAAA3434AAAA34343
343434343434343434343434343434343434343AAAAAAAAAA43434343AAA3434AAAAA43434AAA43434AAAAAAAAAA34343434343434AAAAAA343AAAA43434
4343434343434343434343434343434343434343434AAAAAA34343434AAA4343AAAA434343AAA3434AAAAAAAAAAAAAA34343434AAAAAAAAA434AAAA34343
3434343434343434AAA4343434343434343434343434AAAAA434343434AAA434AAAA34343AAAA4343AAAAAAAAAAAAAAA34343AAAAAAAAAAA3434AAA43434
434343434343434AAAA34343434343434343434343434AAAA343434343AAA343AAAA43434AAA4343AAAAAAAAAAAAAAAAAAAAAAAAAAAAAAAA4343AAA34343
343434343434AAAAAAA434343434343434343434343434AAA43434343AAAA434AAAA34343AAA3434AAA434343434AAAAAAAAAAAAAAAAA4343434AAA43434
43434343434AAAAAAA4343434343434343434343434343AAAA434343AAAAA343AAAA43434AAA4343AAA34343434343AAAAAAA34343434343434AAAAAAAAA
34343434343AAAAAAA3434343434343434343434343434AAAA343434AAAA3434AAAA34343AAA343AAAA434343434343AAAAA343434343434343AAAAAAAAA
4343434343AAAAAAAA4343434343434343434343434343AAAAA3434AAAA34343AAAA43434AAA434AAAAAAAAAA343434AAAAA434343434343AAAAAAAAAAAA
3434343434AAAAAAA434343434343434343434343434AAAAAAAAAAAAAA343434AAA434343AAA343AAAAAAAAAAA34343AAAAA3434AAA434AAAAAAAAA43434
4343434343AAAAAAA343434343434343434343434343AAAAAAAAAAAAA34343AAAAA34343AAAA4343AAAAAAAAA34343AAAAAA434AAAAAAAAAAAAAAAA34343
343434343AAAAAAA34343434343AAA3434343434AAAAAAAAAAAAAAAAA4343AAAAA343434AAAA3434AAAAAAAA343434AAAAAA3434AAAAAAAAAAAAA4343434
434343434AAAAAA3434343434AAAAA43434343AAAAAAAAAAAAAAAAAAA343AAAAAA434343AAAA43434AAAAAA34343AAAAAAAA43434AAAAAAAAAAA43434343
343434343AAAA43434AAAAAAAAAAAA3434343AAAAAAAAAAAAAAAAAAAAAAAAAAAAA34343AAAAAA43434AAAAA43434AAAAAAA4343434343434343434343434
434343434AAA43434AAAAAAAAAAAAAAA43434AAAAAAAAA434AAAAAAAAAAAAAAAAAAAAAAAAAAAA3434343AA43434AAAAAAA43434343434343434343434343
34343434AAAA3434AAAAAAAAAAAAAAAAA434AAAAAAA43434343AAAAAAAAAAAAAAAAAAAAAAAAAAA343434343434AAAAA43434343434343434343434343434
43434343AAAA434AAAAAAAAAAA43AAAAAA43AAAAA34343434343AAAAAAAAAAAAAAAAAAAAAAAAAAAA434343434AAAAA4343434AAAAAAA434AAAAAA3434343
3434343AAAAA343AAAAAAAA434343AAAAAAAAAAA3434343434343AAAA434AAAAAAAAAAA4343AAAAAA4343434AAAAA4343434AAAAAAAAAAAAAAAAAA343434
4343434AAAA3434AAA4343434343434AAAAAAAA34343434343434AAAA343434343434343434AAAAAAA4343434AAA43434AAAAAAAAAAAAAAAAAAAAA434343
3434343AAAA434343434343434343434AAAAAA3434343434343434AAA4343434343434343434AAAAAAAAA4343AAA3434AAAAAAA43434AAA4343AAA343434
4343434AAA434343434343AAAAA34AAAAAAA434343434343434343AAAAA343434343434343434AAAAAAAA3434AAA434AAAAAAA434343AAA3434AAA434343
343434AAAA34343434343AAAAAAAAAAAAAAA3434343434343434343AAAAAAA3434343434343434343AAAAA343AAA343AAAAA34343434AAA4343AA4343434
434343AAAA4343434AAAAAAAAAAAAAAAAAA3434343434AAAAA43434AAAAAAAA3434343434343434343AAAA434AAA434AAAA3434343AAAA4343AAA3434343
3434343AAA34343AAAAAAAAAAAAAAAA4343434343434AAAAAAA43434AAAAAAAA343434343434343434AAAA343AAA3434AA3434343AAAAA3434AAA4343434
4343434AA343434AAAAAAAAAAAAA43434343434AAA43AAAAAAA34343AAAAAAAA4343434343AAAAAAAAAAAA434AAA43434343434AAAAAAA4343AAA3434343
34343434A434343AAAAAAAAAAAAA343434343AAAAA343AAAAAA4343434AAAAAAAAA434343AAAAAAAAAAAAA343AAAA434343434AAAAAAA4343AAA34343434
43434343434343AAAAAAAAAAAAAA434343AAAAAAAA4343AAAAAA4343434AAAAAAAAA4343AAAAAAAAAAAAAA434AAAAA434343AAAAAAA343434AAA43434343
34343434343434AAAAAAAAAAAA343434AAAAAAAAAA3434343AAAA4343434AAAAAAAA3434AAAAA43434343434AAAAAAA434AAAAAAAA3434343AAA34343434
4343AA43434343AAAAAAAAAA4343434AAAAAA343AAA3434343AAA343434343434AAAA343AAA3434343434343AAAAAAAAAAAAAAAA43434343AAA343434343
3434AA34343434AAAAAA343434343AAAAAAA3434AAAA343434AAAA34343434343AAAA434343434343434343AAAAAAAAAAAAAAAA4343434AAAAA434343434
4343AAA3434343AAAA434343434AAAAAAA4343434AAAA34343AAAAA3434343434AAAA343434343AAAAAAAAAAAAAAAAAAAAAAA34343434AAAAA4343434343
3434AAA4343434AAA434343434AAAAAAA434343434AAA43434AAAAAAAAA434343AAAA434343AAAAAAAAAAAAAAAAAAAA434343434343AAAAAA43434343434
4343AAA3434343AAAA43434343AAAAAA4343434343AAAA4343AAAAAAAAAAAA434AAAA34343AAAAAAAAAAAAAAAAAAA3434343434343AAAAAA434343434343
3434AAA43434343AAA343434AAAAAA343434343434AAAAA4343AAAAAAAAAAA3434AAA434AAAAAAAAA43434343AAA34343434343AAAAAAAA4343434343434
4343AAA34343434AAA434343AAAAA343434343434343AAA3434AAAAAAAAAAAA3434AAAAAAAAAA343434343434343434343434AAAAAAAAA43434343434343
3434AAA43434343AAA343434AAAAAA34343434343434AAAA3434AAAA343AAAA4343AAAAAAAAAA43434343434343434AA34343AAAAAAA3434343434343434
4343AAAA4343AAAAAAA343434AAAAAAA4343434343434AAA43434AAA434AAAAA434AAAAAAAAAA3434343AAAAAAAAAAAAA34343AAAA434343434343434343
3434AAAA34AAAAAAAAA4343434AAAAAAA434343434343AAA34343AAA3434AAAA3434AA343AAAAAAAAAAAAAAAAAAAAAAAAA3434AA34343434343434343434
43434AAAAAAAAAAAAAAA43434343AAAAAAA3434343434AAA43434AAA43434AAA43434A43434AAAAAAAAAAAAAAAAAAAAAAAA3434343434343434343434343
34343AAAAAAAAA3AAAAA343434343AAAAAAAA4343434AAAA34343AAAA4343AAAA4343434343AAAAAAAAAAAA43434AAAAAAA4343434343434343434343434
43434AAAAAAAA343AAAA434343AAAAAAAAAAAAAAAAAAAAAA434343AAA34343AAA343434343434AAAAA434343434343434343434343434343434343434343
34343AAAAAA43434AAAA34343AAAAAAAAAAAAAAAAAAAAAA4343434AAAA3434AAA43434343434343434343434343434343434343434343434343434343434
434343AAAAA34343AAAAAA4AAAAAAAAAAAAAAAAAAAAAAAA34343434AAAA343AAA34343434343434343434343AAAA43434343434343434343434343434343
343434AAAAA43434AAAAAAAAAAAAAAAAAAAAA43AAAA43AAA3434343AAAA434AAA4343434343434343434343AAAAAA4343434343434343434343434343434
434343AAAAAA43434AAAAAAAAAA34AAAAAAA434AAA4343AA43434343AAAAAAAAAA4343434343434343434AAAAAAAAA434343434343434343434343434343
3434343AAAAA343434AAAAAAA43434AAAAAA343AAA3434AAA43434343AAAAAAAAA34343434343434AAAAAAAAAAAAAA343434343434343434343434343434
4343434AAAAA434343AAAAAA4343434AAAA3434AAA4343AAAA43434343AAAAAAAA434343434343AAAAAAAAAAAAAAAA434343434343434343434343434343
3434343AAAAA34343AAAAA343434343AAAA43434AA343434AA34343434AAAAAAAA34343434343AAAAAAAAAAAAAAAAA343434343434343434343434343434
4343434AAAAA4343AAAAA343434343AAAA434343AA434343AAA343434343AAAAAA43434343434AAAAAAAAAAAAAAAA3434343434343434343434343434343
3434343AAAA43434AAAAA434343434AAAA343434AA343434AAA434343434AAAAAA34343434343AAAAAAAAAAAAAAA34343434343434343434343434343434
434343AAAA43434AAAAA43434343AAAAA3434343AA4343AAAAAAA34343434AAAA34343434343434AAAAAA343434343434343434343434343434343434343
343434AAAA34343AAAAA343434AAAAAAA4343434343434AAAAAAAAA434343AAAA43434343434343434343434343434343434343434343434343434343434
434343AAAA43434AAAAA434343AAAAAA4343434343434AAAAAAAAAAAA34343AAA34343434343434343434343434343434343434343434343434343434343
3434343AAA34343AAAA4343434AAAAA434AAAA343434AAAA34AAAAAAAAA434AAA43434343434343434343434343434343434343434343434343434343434
4343434AAA4343AAAAA343434AAAAA434AAAAAAAAAAAAAA343434AAAAAA343AAA34343434343434343434343434343434343434343434343434343434343
34343434AA3434AAAA3434343AAAA434AAA43AAAAAAAAA3434343434343434AAA43434343434343434343434343434343434343434343434343434343434
43434343AA4343AAAA4343434AAAA34AAAA343AAA343434343434343434343AAA34343434343434343434343434343434343434343434343434343434343
34343434343434AAA43434343AAAA43AAA3434343434343434AAA4343434AAAAAA3434343434343434343434343434343434343434343434343434343434
43434343434343AAA34343434AAAA34AAA4343434343AA4343AAA34343AAAAAAAAA343434343434343434343434343434343434343434343434343434343
34343434343434AAA43434343AAAA43AAAA4343AAAAAAAAAAAAAA4343AAAAAAAAAAA34343434343434343434343434343434343434343434343434343434
434343434343434AA3434343AAAAA343AAAAAAAAAAAAAAAAAAA34343AAAAAAAAAAAAA3434343434343434343434343434343434343434343434343434343
343434343434343434343434AAAAA4343AAAAAAAA43434343434343AAAAA343434AAAA343434343434343434343434343434343434343434343434343434
434343434343434343434343AAAAA34343434343434343434343434AAA43434343AAAA434343434343434343434343434343434343434343434343434343
