343434343434343434343434343434CA22AB36AAA22221111222AAAB3434343434CA2222AA5434343434343
4343434343434343434343434343436A22A54CAAA22221112222AAA543434343436AA222A54343434343434
343434343434343434343434343434CA2A5436AAA2222212222AAA54343434343436A222AB3434343434343
43434343434343434343434343434CA22AB3436AAA2222222AAAA54343434343434CA22AA54343434343434
3434343434343434343434343434CA222A5434CAAAA22222AAAA543434343434CBCAA22A543434343434343
434343434343434343434343434CA222A543436AAAA22222AAA5434343434CBCAAAAA22AB34343434343434
34343434343434343434343434CA222A543434CAAAA2222AAA5434343434CAAAAA2222AA543434343434343
4343434343434343434343434CA222A54343436AAAA222AAA5434343434CAAA222AAAAA5434343434343434
3434343434343434CB343434CA222A5434343436AAA22AAA5434343434CAAA22AA565654343434343434343
434343434343434CAAB343436A222AB3434343436AA22AA5434343434CAAA22AA5434343434343434343434
343434343434CBCAAAABCB34CA222AAB3434343436AA2A5434343434CAAA22AA54343434343434343434343
43434343434CAAAAAAAAAAB36A2222AAB3434343436AAAB34343434CAAA22AA543434343434343434343434
3434343434CAAAAAAAAAAA5436A2222AAB3434343436AA5434343436AA22AA5434343434343434343434343
434343434CAAAAAAAAAAAAB3436AA2222AB34343434365434343434CA22AA54343434343434343434343434
3434343436AAAAAAAAAAAA543436AAA222ABCB3434343434343434CA22AA543434343434343434343434343
43434343436AAAAAAAA22AB34343656A222AAAB34343434343434CAA2AA5434343434343434343434343434
343434343436AAAAA22222AB34343436A2222AAB34343434343436AA2A54343434343434343434343434343
4343434343436AAA222222A5434343436AA222AAB34343434343436A2AB3434343434343434343434343434
34343434343436AA222222AB3434343436AA222AAB343434343434CA22AB343434343434343434343434343
434343434343436AA22222AAB3434343436AA222A543434343434CAA22AAB34343434343434343434343434
3434343434343436AAA222AA543434343436A2222B34343434CBCAA2222AAB3434343434343434343434343
43434343434343436AA2222AB3434343434CA2222AB343434CAAA2222122A54343434343434343434343434
343434343434343436A2222AAB3434343436A222AA543434CAA222222222AB3434343434343434343434343
43434343434343434CAA222AAAB34343434CA22AA543434CAA222AAAAAA22AB343434343434343434343434
343434343434343436AA2222AA5434343436A22A543434CAA22AAA5656AA22AB34343434343434343434343
4343434343434343436AA2222AB34343434CA22AB3434CA222A56543436A222AB3434343434343434343434
34343434343434343436A2222A54343434CAA22AAB34CAA2AA5434343436A22AAB343434343434343434343
434343434343434343436A222AB343434CAA2222AABCAA22A543434343436A22A5434343434343434343434
34343434343434343434CA222A5434CBCAA221122AAAA22AAB3434343434CA22AB343434343434343434343
434343434343434343436AA22AB34CAAAA22211122222222AAB3434343436AA22AB34343434343434343434
3434343434343434343436A22AABCAAA22222222222221122AAB3434343436A22AAB3434343434343434343
434343434343434343434CAA2AAAAA222AAAAAAAAAA2221222AABCB34343436A22A54343434343434343434
34343434343434343434CAAA2222222AAA56565656AAA222222AAAAB343434CA22AB3434343434343434343
4343434343434343434CAAA221222AA56543434343656AA22222222ABCB3436A222AB343434343434343434
343434343434343434CAA22222AAAA543434343434343656AAA22222AAAB34CA222AAB34343434343434343
43434343434343434CAA2222AAA565434343434343434343656AA222222ABCAA2222A543434343434343434
343434343434CBCBCAA222AAAA54343434343434CB3434343436AA222222AAA22222ABCB343434343434343
43434343434CAAAAAA222AA5654343434343434CAAB343434343656A2222222222222AAAB34343434CB3434
34CBCB3434CAAA22222AAA5434343434343434CAAAAB343434343436A222222211122AAAABCB3434CAABCBC
4CAAAAB34CAA2222AAA565434343434343434CAAAAA54343434343436AA22221111222AAAAAAB34CAAAAAAA
CAA22AABCAA222AAAA543434343434343434CAAAAAAB34343434343436AA222211222222AAAAABCAAAA2222
6AA222AAA2222AA5654343434343434343436AAA2AAAB34343434343436AA22222222222222AAAAAA222211
36AA222222AAAA543434343434343434343436AA2AAA54343434343434CAA2222AAA2222222222222222211
436AA2212AA56543434343434343434343434CAA22AAB343434343434CAA2222AAAAAA22222222222222222
3436AA2122AB34343434343434343434343436AA222AAB3434343434CAA22222AA56AAAA2222222222AAAAA
43436A22122AB343434343434343434343434CAA2222A5434343434CAAA2222AA543656AAAAAAA222AA5656
343436A22122AB343434343434343434343436AAA222AB34343434CAAA2222AA5434343656AAAAAAAA54343
4343436A21112AB343434343434343434343436AA222AAB34343436AA2222AA543434343436565656543434
343434CA21111254343434343434343434343436AA222AAB343434CAA222AA5434343434343434343434343
4343436A217812B34343434343434343434343436A2222AAB3434CAA222AA54343434343434343434343434
34343436A2DI825434343434343434343434343436A2222AAB34CAA222AA543434343434343434343434343
4343434CA2D9E2B3434343434343434343434343436A2222AAB3622222A5434343434343434343434343434
34343436A2D9E2AB3434343434343434343434343436AA22222BC2222A54343434343434343434343434343
4343434362FJI82AB3434343434343434343434343436AA222256222AAB3434343434343434343434343434
34343434362FJI82AB3434343434343434343434343436AA565436AAAA54343434343434343434343434343
434343434362FJI825434343434343434343434343434365434343656543434343434343434343434343434
3434343434362D9E2B343434343434343434343434343434343434343434343434343434343434343434343
43434343434C2D9E25434343434343434343434343434343434343434343434343434343434343434343434
