112233445566778834343434343222343434342222222222222222223434343434342224343434343434343
112233445566778843434343434222434343432222222222222222224343434343432223434343434343434
99AABBCCDDEEFFGG34343434343222343434342222222222222222243434343434342224343434343434343
99AABBCCDDEEFFGG43434343434222434343432222222222222222434343434343432223434343434343434
HHIIJJKKLLMM111134343434343222343434342222222222222224343434343434322224343434343434343
HHIIJJKKLLMM111143434343434222434343432222222222222243434343434322222223434343434343434
343434343434343434343434343222243434342222222222222434343434322222222224343434343434343
434343434343434343434343434222234343432222222222224343434343222222222343434343434343434
343434343434343434343434343422243434342222222222343434343432222222343434343434343434343
434343434343434343434343434322234343434322222223434343434322222343434343434343434343434
343434343434343432222434343422243434343432222234343434343222222434343434343434343434343
434343434343422222222243434322224343434342222343434343432222234343434343434343434343434
343434343422222222222234343422223434343432222434343434342222343434343434343434343434343
434343434322222222222243434342224343434343434343434343422223434343434343434343434343434
343434343422222222222234343432223434343434343434343434322224343434343434343434343434343
434343434342222222222243434342222343434343434343434343422243434343434343434343434343434
343434343434222222222434343432222434343434343434343434322234343434343434343434343434343
434343434343434343434343434343222343434343434343434343422243434343434343434343434343434
343434343434343434343434343434222434343434343434343434322234343434343434343434343434343
434343432222434343434343434343222243434343434343434343422223434343434343434343434343434
343434342222243434343434343434222234343434343434343432222224343434343434343434343434343
434343432222224343434343434343422243434343434343422222222222234343434343434343434343434
343434342222222434343434343434322224343434343432222222222222243434343434343434343434343
434343432222222343434343434343422223434343434342222222222222224343434343434343434343434
343434342222222434343434343434342222343434343422222224343222222434343434343434343434343
434343432222222243434343434343432222434343434222222343434322222243434343434343434343434
343434342222222234343434343434343222243434343222223434343432222224343434343434343434343
434343432222222223434343434343434222222222222222234343434342222223434343434343434343434
343434343222222224343434343434343422222222222222222222222222222224343434343434343434343
434343434222222223434343434343432222222222222222222222222222222223434343434343434343434
343434343422222224343434343434322222222222222222222222222222222224343434343434343434343
434343434342222223434343434343222222222222222222222222222222222222434343434343434343434
343434343434222224343434343432222222343434343434222222222222222222243434343434343434343
434343434343422222434343434322222223434343434343434222222222222222224343434343434343434
343434343434342222243434342222222234343434343434343434222222222222222434343434343434343
434343434343434222224343422222222343434343434343434343434222222222222343434343434343434
343434343434343422222432222222223434343434343434343434343434342222222234343434343434343
434343434343434342222222222222234343434343434343434343434343434322222222222222224343434
343434343434343434222222222224343434343434343434343434343434343432222222222222222224342
434343434343434343222222222343434343434343434343434343434343434322222222222222222222222
343434343434343422222222243434343434343434343434343434343434322222222222222222222222222
434343434343432222222223434343434343434343434343434343434342222222222222222222222222222
343434343434322222222234343434343434343434343434343434343422222222222222222222222222222
434343434342222222224343434343434343434343434343434343434222222222222222222222222222222
343434343422222222223434343434343434343434343434343434342222222222343434343434343434342
434343434222222222434343434343434343434343434343434343222222222223434343434343434343434
343434322222222234343434343434343434343434343434343434222222222234343434343434343434343
434343422222222343434343434343434343434343434343434343222222222343434343434343434343434
343434322222223434343434343434343434343434343434343434222222223434343434343434343434343
434343422222234343434343434343434343434343434343434343222222234343434343434343434343434
343434342222223434343434343434343434343434343434343434222222343434343434343434343434343
434343434222224343434343434343434343434343434343434343222223434343434343434343434343434
343434343222222434343434343434343434343434343434343434343434343434343434343434343434343
434343434322222243434343434343434343434343434343434343434343434343434343434343434343434
343434343432222234343434343434343434343434343434343434343434343434343434343434343434343
434343434343222223434343434343434343434343434343434343434343434343434343434343434343434
343434343434222224343434343434343434343434343434343434343434343434343434343434343434343
434343434343222223434343434343434343434343434343434343434343434343434343434343434343434
