152 152
1 2 9
11223344111111111111111111111111111111111111111111111111111111111111111111133333333311111111111111111111111111111111111111111111111111111111111111111111
11223344111111111111111111111111111111111111111111111111111111111111111111133333333391111111111111111111111111111111111111111111111111111111111111111111
99667788111111111111111111111111111111111111111111111111111111111111111111123333333331111111111111111111111111111111111111111111111111111111111111111111
99667788111111111111111111111111111111111111111111111111111111111111111111113333333339111111111111111111111111111111111111111111111111111111111111111111
55AABBCC111111111111111111111111111111111111111111111111111111111111111111113333333333911111111111111111111111111111111111111111111111111111111111111111
55AABBCC111111111111111111111111111111111111111111111111111111111111111111113333333333391111111111111111111111111111111111111111111111111111111111111111
DDEEFFGG111111111111111111111111111111111111111111111111111111111111111111112333333333339111111111111111111111111111111111111111111111111111111111111111
DDEEFFGG111111111111111111111111111111111111111111111111111111111111111111111333333333333111111111111111111111111111111111111111111111111111111111111111
11111111111111111111111111111111111111111111111111111111111111111111111111111233333333333111111111111111111111111111111111111111111111111111111111111111
11111111111111111111111111111111111111111111111111111111111111111111111111111133333333333911111111111111111111111111111111111111111111111111111111111111
11111111111111111111111111111111111111111111111111111111111111111111111111111123333333333311111111111111111111111111111111111111111111111111111111111111
11111111111111111111111111111111111111111111111111111111111111111111111111111113333333333391111111111111111111111111111111111111111111111111111111111111
11111111111111111111111111111111111111111111111111111111111111111111111111111112233333333331111111111111111111111111111111111111111111111111111111111111
11111111111111111111111111111111111111111111111111111111111111111111111111111111133333333339111111111111111111111111111111111111111111111111111111111111
11111111111111111111111111111111111111111111111111111111111111111111111111111111123333333333111111111111111111111111111111111111111111111111111111111111
11111111111111111111111111111111111111111111111111111111111111111111111111111111113333333333111111111111111111111111111111111111111111111111111111111111
11111111111111111111111111111111111111111111111111111111111111111111111111111111113333333333111111111111111111111111111111111111111111111111111111111111
11111111111111111111111111111111111111111111111111111111111111111111111111111111112333333332111111111111111111111111111111111111111111111111111111111111
11111111111111111111111111111111111111111111111111111111111111111111111111111111111333333331111111111111111111111111111111111111111111111111111111111111
11111111111111111111111111111111111111111111111111111111111111111111111111111111111233333331111111111111111111111111111111111111111111111111111111111111
11111111111111111111111111111111111111111111111111111111111111111111111111111111111133333331111111111111111111111111111111111111111111111111111111111111
11111111111111111111111111111111111111111111111111111111111111999999911111111111111123333339111111111111111111111111111111111111111111111111111111111111
11111111111111111111111111111111111111111111111111111111111119333333399911111111111113333333111111111111111111111111111111111111111111111111111111111111
11111111111111111111111111111111111111111111111111111111111193333333333399111111111193333333111111111111111111111111111111111111111111111111111111111111
11111111111111111111111111111111111111111111111111111111111133333333333333991111111133333333111111111111111111111111111111111111111111111111111111111111
11111111111111111111111111111111111111111111111111111111111933333333333333339911111933333332111111111111111111111111111111111111111111111111111111111111
11111111111111111111111111111111111111111111111111111111119333333333333333333391119333333331111111111111111111111111111111111111111111111111111111111111
11111111111111111111111111111111111111111111111111111111113333333333333333333339993333333321111111111111111111111111111111111111111111111111111111111111
11111111111111111111111111111111111111111111111111111111193333333333333333333333333333333211111111111111111111111111111111111111111111111111111111111111
11111111111111111111111111111111111111111111111111111111933333333333333333333333333333333111111111111111111111111111111111111111111111111111111111111111
11111111111111111111111111111111111111111111111111111199333333333333333333333333333333332111111111111111111111111111111111111111111111111111111111111111
11111111111111111111111111111111111111111111111999999933333333333333333333333333333333321111111111111111111111111111111111111111111111111111111111111111
11111111111111111111111111111111111111111111199333333333333333333333333333333333333333211111111111111111111111111111111111111111111111111111111111111111
11111111111111111111111111111111111111111111933333333333333333333333333333332223333333111111111111111111111111111111111111111111111111111111111111111111
11111111111111111111111111111111111111111111333333333333333333333333333333331113333333911111111111111111111111111111111111111111199999999111111111111111
11111111111111111111111111111111111111111111333333333333333333322222233333321113333333311111111999111111111111111111111111111119933333333999111111111111
11111111111111111111111111111111111111111111333333333333333322211111123333211112333333311111119333999999911111111999911111111993333333333333911111111111
11111111111111111111111111111111111111111199333333333333333211111111112222111111233333399111993333333333399999999333391111119333333333333333311111111111
11111111111111111111111111111111111111111933333333333333332111111111111111111111133333333999333333333333333333333333339999993333333333333333311111111111
11111111111111111111111111111111111111119333333333333333221111111111111111111111133333333333333333333333333333333333333333333333333333333333311111111111
11111111111111111111111111111111111111113333333333333332111111111111111111111111933333333333333333333333333333333333333333333333333333333333311111111111
11111111111111111111111111111111111111113333333333333321111111111111111111111111333333333333333333333333333333333333333333333333333333333333311111111111
11111111111111111111111111111111111111113333333333333311111111111111111111111111333333333333333333333333333333333333333333333333333333333333311111111111
11111111111111111111111111111111111111112333333333333311111111111111111111111111333333333333333333333333333333333333333333333333333333333333211111111111
11111111111111111111111111111111111111111233333333333211111111111111111111111111333333333333333333333333333333333333333333333333333333333333911111111111
11111111111111111111111111111111111111111133333333332111111111111111111111111111333333333333333333333332222222333333333333333333333333333333311111111111
11111111111111111111111111111111111111111933333333331111111111111111111111111111233333333322233333333221111111233333333333333333333333333333391111111111
11111111111111111111111111111111111111111333333333331111111111111111111111111111123333333211123333332111111111133333333333333333333333333333331111111111
11111111111111111111111111111111111111199333333333331111111111111111111111111111113333333111113333321111111111122333333333333333333333333333331111111111
11111111111111111111111111111111111111133333333333331111111111111111111111111111112333332111112233211111111111111333333333333333333333333333339111111111
11111111111111111111111111111111111111133333333333331111111111111111111111111111111333321111111122111111111111111333333333333333333333333333333911111111
11111111111111111111111111111111111111123333333333321111111111111111111111111111111223211111111111111111111111111233333333333333333333333333333311111111
11111111111111111111111111111111111111113333333333311111111111111111111111111111111112111111111111111111111111111123333333333333333333333333333311111111
11111111111111111111111111111111111111112333333333211111111111111111111111111111111111111111111111111111111111111112333222223333333333323333333311111111
11111111111111111111111111111111111111111223333333111111111111111111111111111111111111111111111111111111111111111111222111112233333333312333333211111111
11111111111111111111111111111111111111111112333333911111111111111111111111111111111111111111111111111111111111111111111111111133333333311233332111111111
11111111111111111111111111111111111111111111223333311111111111111111111111111111111111111111111111111111111111111111111111111133333333311122331111111111
11111111111111111111111111111111111111111111113333311111111111111111111111111111111111111111111111111111111111111111111111111133333333311111221111111111
11111111111111111111111111111111111111111111193333399111111111111111111111111111111111111111111111111111111111111111111111111933333333311111111111111111
11111111111111111111111111111111111111111111133333333111111111111111111111111111111111111111111111111111111111111111111111119333333333311111111111111111
11111111111111111111111111111111111111111111133333333911111111111111111111111111111111111111111111111111111111111111111111193333333333211111111111111111
11111111111111111111111111111111111111111111133333333391111111111111111111111111111111111111111111111111111111111111111111133333333333111111111111111111
11111111111111111111111111111111111111111111933333333339911111119911111111111199999999911111111111111111111111111111111111133333333333111111111111111111
11111111199999991111111111111111111111111119333333333333391111193391111111111933333333391111111111111111111111111111111111123333333333911111111111111111
11111119933333339111111111111111111111111113333333333333339111933339111111119333333333339111111111111199911111111111111111112333333333311111111111111111
11111993333333333911111111111111111111111193333333333333333999333333991111193333333333333999111111111933399111111111111111111223333333391111111111111111
11111333333333333399111111111111111111199933333333333333333333333333339919933333333333333333111111111333333911111111111111111113333333331111111111111111
11199333333333333333111111111111119999933333333333333333333333333333333393333333333333333333911111119333333391111111111111111112333333331111111111111111
11133333333333333333911111111119993333333333333333333333333333333333333333333333333333333333311111193333333339991111111111111111233333331111111111111111
11933333333333333333391111119993333333333333333333333333333333333333333333333333333333333333399999933333333333339991111111111111133333331111111111111111
11333333333333333333339119993333333333333333333333333333333333333333333333333333333333333333333333333333333333333331111111111111123333331111111111111111
11333333333333333333333993333333333333333333333333333333333333333333333333333333333333333333333333333333333333333331111111111111113333331111111111111111
11333333333333333333333333333333333333333333333333333333333333333333333333333333333333333333333333333333333333333331111111111111113333331111111111111111
11333333333333333333333333333333333333333333333333333333333333333333333333333333333333333333333333333333333333333339111111111111113333321111111111111111
11333333333333333333333332333222233333332222222222233333333333333333333333333333333333333333333333333333333333333333111111111111113333311111111111111111
11333333333333333333333321232111122223321111111111122222333333333333332223333333333333333333333333333333333333333333911111111111993333311111111111111111
11333333333333333333333211121111111112211111111111111111233333333332221112222233333333333333333333333332333333333333391111111119333333211111111111111111
11333333333333333333332111111111111111111111111111111111122233333221111111111123333222333333333333333321233333333333331111111113333333111111111111111111
11333333333333333333321111111111111111111111111111111111111122322111111111111112332111233333333333333211123333333333339911111993333332111111111111111111
11333333333333333333211111111111111111111111111111111111111111211111111111111111221111122333333333333911112333333333333391119333333331111111111111111111
11233333333333333333111111111111111111111111111111111111111111111111111111111111111111111223333333333391199333333333333339993333332221111111111111111111
11133333333333333332111111111111111111111111111111111111111111111111111111111111111111111113333333333339933333333333333333333333321111111111111111111111
11123333333333333321111111111111111111111111111111111111111111111111111111111111111111111113333333333333333333333333333333333333211111111111111111111111
11112233333333332211111111111111111111111111111111111111111111111111111111111111111111199993333333333333333333333333322333333332111111111111111111111111
11111122333333221111111111111111111111111111111111111111111111111111111111111111111199933333333333333333333333333333211222222221111111111111111111111111
11111111222222111111111111111111111111111111111111111111111111111111111111111111199933333333333333333333333333333333111111111111111111111111111111111111
11111111111111111111111111111111111111111111111111111111111111111111111111111111133333333333333333333333333333333333111111111111111111111111111111111111
11111111111111111111111111111111111111111111111111111111111111111111111111111111933333333333333333333333333333333333111111111111111111111111111111111111
11111111111111111111111111111111111111111111111111111111111111111111111111111111333333333333333333333333333333333332111111111111111111111111111111111111
11111111111111111111111111111111111111111111111111111111111111111111111111111111333333333333333333333333333333333331111111111111111111111111111111111111
11111111111111111111111111111111111111111111111111111111111111111111111111111111333333333333333333333333333333333321111111111111111111111111111111111111
11111111111111111111111111111111111111111111111111111111111111111111111111111111233333333333333333333333333333333311111111111111111111111111111111111111
11111111111111111111111111111111111111111111111111111111111111111111111111111111133333222222333333333333333333333311111111111111111111111111111111111111
11111111111111111111111111111111111111111111111111111111111111111111111111111111123222111111222333333333333333333391111111111111111111111111111111111111
11111111111111111111111111111111111111111111111111111111111111111111111111111111112111111111111233333333333333333339111111111111111111111111111111111111
11111111111111111111111111111111111111111111111111111111111111111111111111111111111111111111111122233333333333333333911111111111111111111111111111111111
11111111111111111111111111111111111111111111111111111111111111111111111111111111111111111111111111123333333333333333311111111111111111111111111111111111
11111111111111111111111111111111111111111111111111111111111111111111111111111111111111111111111111112333333333333333311111111111111111111111111111111111
11111111111111111111111111111111111111111111111111111111111111111111111111111111111111111111111111111233333333333333311111111111111111111111111111111111
11111111111111111111111111111111111111111111111111111111111111111111111111111111111111111111111111111122333333333333311111111111111111111111111111111111
11111111111111111111111111111111111111111111111111111111111111111111111111111111111111111111111111111111333333333333311111111111111111111111111111111111
11111111111111111111111111111111111111111111111111111111111111111111111111111111111111111111111111111111333333333333311111111111111111111111111111111111
11111111111111111111111111111111111111111111111111111111111111111111111111111111111111111111111111111111333333333333391111111111111111111111111111111111
11111111111111111111111111111111111111111111111111111111111111111111111111111111111111111111111111111111333333333333339111111111111111111111111111111111
11111111111111111111111111111111111111111111111111111111111111111111111111111111111111111111111111111111223333333333333111111111111111111111111111111111
11111111111111111111111111111111111111111111111111111111111111111111111111111111111111111111111111111111113333333333333911111111111111111111111111111111
11111111111111111111111111111111111111111111111111111111111111111111111111111111111111111111111111111111113333333333333311111111111111111111111111111111
11111111111111111111111111111111111111111111111111111111111111111111111111111111111111111111111111111111112333333333333311111111111111111111111111111111
11111111111111111111111111111111111111111111111111111111111111111111111111111111111111111111111111111111111333333333333311111111111111111111111111111111
11111111111111111111111111111111111111111111111111111111111111111111111111111111111111111111111111111111111233333333333311111111111111111111111111111111
11111111111111111111111111111111111111111111111111111111111111111111111111111111111111111111111111111111111133333333333311111111111111111111111111111111
11111111111111111111111111111111111111111111111111111111111111111111111111111111111111111111111111111111111133333333333311111111111111111111111111111111
11111111111111111111111111111111111111111111111111111111111111111111111111111111111111111111111111111111111133333333333391111111111111111111111111111111
11111111111111111111111111111111111111111111111111111111111111111111111111111111111111111111111111111111111133333333333331111111111111111111111111111111
11111111111111111111111111111111111111111111111111111111111111111111111111111111111111111111111111111111111133333333333331111111111111111111111111111111
11111111111111111111111111111111111111111111111111111111111111111111111111111111111111111111111111111111111133333333333339111111111111111111111111111111
11111111111111111111111111111111111111111111111111111111111111111111111111111111111111111111111111111111111133333333333333911111111111111111111111111111
11111111111111111111111111111111111111111111111111111111111111111111111111111111111111111111111111111111111133333333333333311111111111111111111111111111
11111111111111111111111111111111111111111111111111111111111111111111111111111111111111111111111111111111111133333333333333391111111111111111111111111111
11111111111111111111111111111111111111111111111111111111111111111111111111111111111111111111111111111111111133333333333333331111111111111111111111111111
11111111111111111111111111111111111111111111111111111111111111111111111111111111111111111111111111111111111123333333333333331111111111111111111111111111
11111111111111111111111111111111111111111111111111111111111111111111111111111111111111111111111111111111111113333333333333331111111111111111111111111111
11111111111111111111111111111111111111111111111111111111111111111111111111111111111111111111111111111111111112333333333333321111111111111111111111111111
11111111111111111111111111111111111111111111111111111111111111111111111111111111111111111111111111111111111111333333333333311111111111111111111111111111
11111111111111111111111111111111111111111111111111111111111111111111111111111111111111111111111111111111111111333333333333211111111111111111111111111111
11111111111111111111111111111111111111111111111111111111111111111111111111111111111111111111111111111111111111333333333333111111111111111111111111111111
11111111111111111111111111111111111111111111111111111111111111111111111111111111111111111111111111111111111111333333333333111111111111111111111111111111
11111111111111111111111111111111111111111111111111111111111111111111111111111111111111111111111111111111111111333333333332111111111111111111111111111111
11111111111111111111111111111111111111111111111111111111111111111111111111111111111111111111111111111111111119333333333331111111111111111111111111111111
11111111111111111111111111111111111111111111111111111111111111111111111111111111111111111111111111111111111193333333333339111111111111111111111111111111
11111111111111111111111111111111111111111111111111111111111111111111111111111111111111111111111111111111111133333333333333911111111111111111111111111111
11111111111111111111111111111111111111111111111111111111111111111111111111111111111111111111111111111111111933333333333333391111111111111111111111111111
11111111111111111111111111111111111111111111111111111111111111111111111111111111111111111111111111111111111333333333333333339111111111111111111111111111
11111111111111111111111111111111111111111111111111111111111111111111111111111111111111111111111111111111111333333333333333333111111111111111111111111111
11111111111111111111111111111111111111111111111111111111111111111111111111111111111111111111111111111111119333333333333333333111111111111111111111111111
11111111111111111111111111111111111111111111111111111111111111111111111111111111111111111111111111111111113333333333333333333111111111111111111111111111
11111111111111111111111111111111111111111111111111111111111111111111111111111111111111111111111111111111113333333333333333333911111111111111111111111111
11111111111111111111111111111111111111111111111111111111111111111111111111111111111111111111111111111111113333333333333333333311111111111111111111111111
11111111111111111111111111111111111111111111111111111111111111111111111111111111111111111111111111111111193333333333333333333311111111111111111111111111
11111111111111111111111111111111111111111111111111111111111111111111111111111111111111111111111111111111133333333333333333333311111111111111111111111111
11111111111111111111111111111111111111111111111111111111111111111111111111111111111111111111111111111111933333333333333333333391111111111111111111111111
11111111111111111111111111111111111111111111111111111111111111111111111111111111111111111111111111111111333333333333333333333331111111111111111111111111
11111111111111111111111111111111111111111111111111111111111111111111111111111111111111111111111111111111333333333333333333333331111111111111111111111111
11111111111111111111111111111111111111111111111111111111111111111111111111111111111111111111111111111111333333333333333333333339111111111111111111111111
11111111111111111111111111111111111111111111111111111111111111111111111111111111111111111111111111111111333333333333333333333333111111111111111111111111
11111111111111111111111111111111111111111111111111111111111111111111111111111111111111111111111111111111333333333333333333333333911111111111111111111111
11111111111111111111111111111111111111111111111111111111111111111111111111111111111111111111111111111111333333333333333333333333311111111111111111111111
11111111111111111111111111111111111111111111111111111111111111111111111111111111111111111111111111111111233333333333333333333333391111111111111111111111
11111111111111111111111111111111111111111111111111111111111111111111111111111111111111111111111111111111133333333333333333333333331111111111111111111111
11111111111111111111111111111111111111111111111111111111111111111111111111111111111111111111111111111111133333333333333333333333331111111111111111111111
11111111111111111111111111111111111111111111111111111111111111111111111111111111111111111111111111111111133333333333333333333333331111111111111111111111
11111111111111111111111111111111111111111111111111111111111111111111111111111111111111111111111111111111133333333333333333333333331111111111111111111111

TRANSITION DATA

LIGHTING DATA
0.5
20 20 40
