87 58
1 2 9
111111111111111111133333333311111111111111111111111111933311111111111111111111111111111
111111111111111111133333333391111111111111111111111119333311111111111111111111111111111
111111111111111111123333333331111111111111111111111193333211111111111111111111111111111
111111111111111111113333333339111111111111111111111133333111111111111111111111111111111
111111111111111111113333333333911111111111111111111933332111111111111111111111111111111
111111111111111111113333333333391111111111111111119333321111111111111111111111111111111
111111111111111111112333333333339111111111111111113333311111111111111111111111111111111
111111111111111111111333333333333111111111111111113333311111111111111111111111111111111
111111111111111111111233333333333111111111111111113333311111111111111111111111111111111
111111111111111111111133333333333911111111111111113333311111111111111111111111111111111
111111111111111111111123333333333311111111111111112333391111111111111111111111111111111
111111111111111111111113333333333391111111111111111233339111111111111111111111111111111
111111111111111111111112233333333331111111111111111123333111111111111111111111111111111
111111111111111111111111133333333339111111111111111113333911111111111111111111111111111
111111111199999999111111123333333333111111111111111112333391111111111111111111111999999
111111119933333333991111113333333333111111111111111111233331111111111111111111199333333
111111193333333333339111113333333333111111111111111111933339111111111111111111933333333
111111133333333333333111112333333332111111111111111111333333999911111111111111333333333
111111133333333333333911111333333331111111111111111111333333333399111111111111333333333
111111133333333333333311111233333331111111111111111119333333333333911111111111333333333
111111133333333333333311111133333331111111111111111113333333333333399111111111333333333
111111933333333333333311111123333339111111111111111993333333233333333111111119333333333
111119333333333333333311111993333333991111111111111333333332122333333911111193333333333
111193333333333333333211119333333333339911111111119333333321111233333311111933333333333
111133333333333332222111113333333333333399111111113333333311111133333391111333333333333
111133333333332221111111193333333333333333991111193333333211111123333331111333333333322
111133333333321111111111933333333333333333339111933333333111111112333331111333333333211
111123333322211111111111333333333333333333333999333333332111111111333339111233333222111
111112222211111111111119333333333333333333333333333333321111111111233333911122222111111
111111111111111111111193333333333333333333333333333333311111111111123333311111111111111
111111111111111111119933333333333333333333333333333333211111111111112333391111111111111
111111111111199999993333333333333333333333333333333332111111111111111233339911111111111
111111111119933333333333333333333333333333333333333321111111111111111123333391111111111
111111111193333333333333333333333333333333222333333311111111111111111113333331111111111
111111111133333333333333333333333333333333111333333391111111111111111112333339991111111
111111111133333333333333333332222223333332111333333331111111199911111111233333339111111
111111111133333333333333332221111112333321111233333331111111933399999991123333333991111
111111119933333333333333321111111111222211111123333339911199333333333339993333333339991
111111193333333333333333211111111111111111111113333333399933333333333333333333333333339
111111933333333333333322111111111111111111111112333333333333333333333333333333333333333
111111333333333333333211111111111111111111111111233333333333333333333333333333333333333
111111333333333333332111111111111111111111111111133333333333333333333333333333333333333
111111333333333333331111111111111111111111111111933333333333333333333222222223333333333
111111233333333333331111111111111111111111111199333333332222333333332111111112233333333
111111123333333333321111111111111111111111111133333333331111233333321111111111122223333
111111113333333333211111111111111111111111111123333333331111123332211111111111111112222
111111193333333333111111111111111111111111111113333333321111112221111111111111111111111
111111133333333333111111111111111111111111111112233333311111111111111111111111111111111
111119933333333333111111111111111111111111111111123333211111111111111111111111111111111
111113333333333333111111111111111111111111111111112222111111111111111111111111111111111
111113333333333333111111111111111111111111111111111111111111111111111111111111111111111
111112333333333332111111111111111111111111111111111111111111111111111111111111111111111
111111333333333331111111111111111111111111111111111111111111111111111111111111111111111
111111233333333321111111111111111111111111111111111111111111111111111111111111111111111
111111122333333311111111111111111111111111111111111111111111111111111111111111111111111
111111111233333391111111111111111111111111111111111111111111111111111111111111111111111
111111111122333331111111111111111111111111111111111111111111111111111111111111111111111
111111111111333331111111111111111111111111111111111111111111111111111111111111111111111

TRANSITION DATA
13 58 west-forest 47 3
14 58 west-forest 48 3
15 58 west-forest 49 3
16 58 west-forest 50 3
17 58 west-forest 51 3
87 40 east-forest 3 31
87 41 east-forest 3 32
87 42 east-forest 3 33
87 43 east-forest 3 34
87 44 east-forest 3 35
87 45 east-forest 3 36

LIGHTING DATA
0.5
20 20 40
