73 32
1 2 9
1111111111111111111111111111111111111111111119333339911111111111111111111
1111111111111111111111111111111111111111111113333333311111111111111111111
1111111111111111111111111111111111111111111113333333391111111111111111111
1111111111111111111111111111111111111111111113333333339111111111111111111
1111111111111111111111111111111111111111111193333333333991111111991111111
1111111119999999111111111111111111111111111933333333333339111119339111111
1111111993333333911111111111111111111111111333333333333333911193333911111
1111199333333333391111111111111111111111119333333333333333399933333399111
1111133333333333339911111111111111111119993333333333333333333333333333991
1119933333333333333311111111111111999993333333333333333333333333333333339
1113333333333333333391111111111999333333333333333333333333333333333333333
1193333333333333333339111111999333333333333333333333333333333333333333333
1133333333333333333333911999333333333333333333333333333333333333333333333
1133333333333333333333399333333333333333333333333333333333333333333333333
1133333333333333333333333333333333333333333333333333333333333333333333333
1133333333333333333333333333333333333333333333333333333333333333333333333
1133333333333333333333333233322223333333222222222223333333333333333333333
1133333333333333333333332123211112222332111111111112222233333333333333222
1133333333333333333333321112111111111221111111111111111123333333333222111
1133333333333333333333211111111111111111111111111111111112223333322111111
1133333333333333333332111111111111111111111999999991111111112232211111111
1133333333333333333321111111111111111111199333333339911111111121111111111
1123333333333333333311111111111111111111933333333333391111111111111111111
1113333333333333333211111111111111111111333333333333331111111111111111111
1112333333333333332111111111111111111111333333333333339111111111111111111
1111223333333333221111111111111111111111333333333333333111111111111111111
1111112233333322111111111111111111111111333333333333333111111111111111111
1111111122222211111111111111111111111119333333333333333111111111111111111
1111111111111111111111111111111111111193333333333333333111111111111111111
1111111111111111111111111111111111111933333333333333332111111111111111111
1111111111111111111111111111111111111333333333333322221111111111111111111
1111111111111111111111111111111111111333333333322211111111111111111111111

TRANSITION DATA
47 1 north-forest 13 56
48 1 north-forest 14 56
49 1 north-forest 15 56
50 1 north-forest 16 56
51 1 north-forest 17 56
73 11 south-forest 3 8
73 12 south-forest 3 9
73 13 south-forest 3 10
73 14 south-forest 3 11
73 15 south-forest 3 12
73 16 south-forest 3 13
73 17 south-forest 3 14

LIGHTING DATA
0.5
20 20 40
