73 32
3 4 5 6 11 12
3434343434343434343434343434343434343434343436AAAAAB343434343434343434343
434343434343434343434343434343434343434343434CAAAAAAB34343434343434343434
34343434343434343434343434343434343434343434CAAAAAAAAB3434343434343434343
4343434343434343434343434343434343434343434CAAAA22AAAAB343434343434343434
343434343434343434343434343434343434343434CAAAA2222AAAABCB343434CB3434343
43434343434CBCB34343434343434343434343434CAAAAA2222AAAAAAAB3434CAAB343434
34343434CBCAAAAB343434343434343434343434CAAAA222222AAAAAAAAB34CAAAABCB343
4343434CAAAAAAAAB3434343434343434343434CAAAAA222222222AAAAAABCAAAAAAAAB34
343434CAAAAAAAAAAB34343434343434343434CAAAAAA222222222222AAAAAAAAAAAAAAB3
43434CAAAAAAAAAAAAB34343434343434CBCBCAAAAA2222222222222222AAAAAA22AAAAAB
3434CAAAAAA22AAAAAAB3434343434CBCAAAAAAA22222222222222222222AA222222AAAAA
4CBCAAAAAA2222AAAAAAB343434CBCAAAAAAAAA2222222222222222222222222222222AAA
36AAAAAAA2222222AAAAAB3434CAAAAAA2222222222222222222222222222222222222222
4CAAAAAA222222222AAAAABCBCAAAA222222222222222222AA22222222222222222222222
36AAAA22222222222AAAAAAAAAAAAAAAA22222222AAAAAAAAAAAA2AAA2222222222222222
4CAAAA2222222222222AAAAAAAAAAAAAAAAAAAAAAAAAAAAAAAAAAAAAAAA222222AAAAAAAA
36AAA222222222222222AAAA56AA5656AAAAAAAA565656565656AAAAAAAAAAAAAAAAAAAAA
4CAAA2222222222222AAAAA54365434365656AA543434343434365656AAAAAAAAAAAA5656
36AAA222222222222AAAAA543434343434343654343434343434343436AAAAAAAA5654343
4CAAA222222222222AAAA5434343434343434343434343434343434343656AA5654343434
36AAA22222222222AAAA54343434343434343434343434343434343434343654343434343
4CAAAA2222222222AAAAB3434343434343434343434CBCBCBCB3434343434343434343434
36AAAAA22222222AAAAA5434343434343434343434CAAAAAAAAB343434343434343434343
436AAAAAA22222AAAAA5434343434343434343434CAAAAAAAAAAB34343434343434343434
3436AAAAAAA2AAAAAA5434343434343434343434CAAAA2222AAAAB3434343434343434343
4343656AAAAAAAA565434343434343434343434CAAAA222222AAAAB343434343434343434
34343436AAAAAA543434343434343434343434CAAAA2222222AAAA5434343434343434343
4343434365656543434343434343434343434CAAAA22222222AAA54343434343434343434
343434343434343434343434343434343434CAAAA22222222AAA543431122334455667788
43434343434343434343434343434343434CAAAA222222222AA5434341122334455667788
343434343434343434343434343434343436AAA2222222AAAA543434399AABBCCDDEEFFGG
4343434343434343434343434343434343436AA222222AA565434343499AABBCCDDEEFFGG

TRANSITION DATA
47 1 north-forest 13 56
48 1 north-forest 14 56
49 1 north-forest 15 56
50 1 north-forest 16 56
51 1 north-forest 17 56
73 11 south-forest 3 8
73 12 south-forest 3 9
73 13 south-forest 3 10
73 14 south-forest 3 11
73 15 south-forest 3 12
73 16 south-forest 3 13
73 17 south-forest 3 14

LIGHTING DATA
0.5
20 20 40
