30 29
1 3
111111111111111111111111111111
111111111111111111111111111111
113333333333333333333333333311
112222222222222222222222222411
112222222222222222222222222211
112222222222222222222222222211
112222222222222222222222222211
334222222222222222222222222211
222222222222222222222222222211
222222222222222222222222222211
114222222222222222222222222211
112222222222222222222222222211
112222222222222222222222222211
112222222222222222222222222211
112222222222222222222222222211
112222222222222111111111122211
112222222222222133333333122211
112222222222222122222222122211
111111111222222122222222122211
113333333222222122222222122211
112222222222222122222222122211
112222222222222122222222122211
112222222222222111122111122211
111111111222222333322333322211
113333333222222222222222222211
112222222222222222222222222211
114222222222222222222222222211
111111111111111111111111111111
111111111111111111111111111111

TRANSITION DATA
1 9 Palace 28 9

LIGHTING DATA
0.5
20 20 40
28 4 248 195 119 300
3 8 248 195 119 300
3 11 248 195 119 300
3 27 248 195 119 300
