30 28
111111111111111111111111111111
111111111111111111111111111111
112222222222222222222222222211
112222222222222222222222222211
112222222222222222222222222211
112222222222222222222222222211
112222222222222222222222222211
112222222222222222222222222211
112222222222222222222222222211
112222222222222222222222222211
112222222222222222222222222211
112222222222222222222222222211
112222222222222222222222222211
112222222222222222222222222211
112222222222221111111111112211
112222222222221111111111112211
112222222222221122222222112211
112222222222221122222222112211
112222222222221122222222112211
112222222222221122222222112211
112222222222221122222222112211
112222222222221122222222112211
112222222222221111122111112211
112222222222221111122111112211
112222222222222222222222222211
112222222222222222222222222211
111111111111111111111111111111
111111111111111111111111111111
