152 152
1 2 5
11223344111111111111111111111111111111111111111111111111111111111111111111133333333311111111111111111111111111111111111111111111111111111111111111111111
11223344111111111111111111111111111111111111111111111111111111111111111111133333333351111111111111111111111111111111111111111111111111111111111111111111
55667788111111111111111111111111111111111111111111111111111111111111111111123333333331111111111111111111111111111111111111111111111111111111111111111111
55667788111111111111111111111111111111111111111111111111111111111111111111113333333335111111111111111111111111111111111111111111111111111111111111111111
99AABBCC111111111111111111111111111111111111111111111111111111111111111111113333333333511111111111111111111111111111111111111111111111111111111111111111
99AABBCC111111111111111111111111111111111111111111111111111111111111111111113333333333351111111111111111111111111111111111111111111111111111111111111111
DDEEFFGG111111111111111111111111111111111111111111111111111111111111111111112333333333335111111111111111111111111111111111111111111111111111111111111111
DDEEFFGG111111111111111111111111111111111111111111111111111111111111111111111333333333333111111111111111111111111111111111111111111111111111111111111111
11111111111111111111111111111111111111111111111111111111111111111111111111111233333333333111111111111111111111111111111111111111111111111111111111111111
11111111111111111111111111111111111111111111111111111111111111111111111111111133333333333511111111111111111111111111111111111111111111111111111111111111
11111111111111111111111111111111111111111111111111111111111111111111111111111123333333333311111111111111111111111111111111111111111111111111111111111111
11111111111111111111111111111111111111111111111111111111111111111111111111111113333333333351111111111111111111111111111111111111111111111111111111111111
11111111111111111111111111111111111111111111111111111111111111111111111111111112233333333331111111111111111111111111111111111111111111111111111111111111
11111111111111111111111111111111111111111111111111111111111111111111111111111111133333333335111111111111111111111111111111111111111111111111111111111111
11111111111111111111111111111111111111111111111111111111111111111111111111111111123333333333111111111111111111111111111111111111111111111111111111111111
11111111111111111111111111111111111111111111111111111111111111111111111111111111113333333333111111111111111111111111111111111111111111111111111111111111
11111111111111111111111111111111111111111111111111111111111111111111111111111111113333333333111111111111111111111111111111111111111111111111111111111111
11111111111111111111111111111111111111111111111111111111111111111111111111111111112333333332111111111111111111111111111111111111111111111111111111111111
11111111111111111111111111111111111111111111111111111111111111111111111111111111111333333331111111111111111111111111111111111111111111111111111111111111
11111111111111111111111111111111111111111111111111111111111111111111111111111111111233333331111111111111111111111111111111111111111111111111111111111111
11111111111111111111111111111111111111111111111111111111111111111111111111111111111133333331111111111111111111111111111111111111111111111111111111111111
11111111111111111111111111111111111111111111111111111111111111555555511111111111111123333335111111111111111111111111111111111111111111111111111111111111
11111111111111111111111111111111111111111111111111111111111115333333355511111111111113333333111111111111111111111111111111111111111111111111111111111111
11111111111111111111111111111111111111111111111111111111111153333333333355111111111153333333111111111111111111111111111111111111111111111111111111111111
11111111111111111111111111111111111111111111111111111111111133333333333333551111111133333333111111111111111111111111111111111111111111111111111111111111
11111111111111111111111111111111111111111111111111111111111533333333333333335511111533333332111111111111111111111111111111111111111111111111111111111111
11111111111111111111111111111111111111111111111111111111115333333333333333333351115333333331111111111111111111111111111111111111111111111111111111111111
11111111111111111111111111111111111111111111111111111111113333333333333333333335553333333321111111111111111111111111111111111111111111111111111111111111
11111111111111111111111111111111111111111111111111111111153333333333333333333333333333333211111111111111111111111111111111111111111111111111111111111111
11111111111111111111111111111111111111111111111111111111533333333333333333333333333333333111111111111111111111111111111111111111111111111111111111111111
11111111111111111111111111111111111111111111111111111155333333333333333333333333333333332111111111111111111111111111111111111111111111111111111111111111
11111111111111111111111111111111111111111111111555555533333333333333333333333333333333321111111111111111111111111111111111111111111111111111111111111111
11111111111111111111111111111111111111111111155333333333333333333333333333333333333333211111111111111111111111111111111111111111111111111111111111111111
11111111111111111111111111111111111111111111533333333333333333333333333333332223333333111111111111111111111111111111111111111111111111111111111111111111
11111111111111111111111111111111111111111111333333333333333333333333333333331113333333511111111111111111111111111111111111111111155555555111111111111111
11111111111111111111111111111111111111111111333333333333333333322222233333321113333333311111111555111111111111111111111111111115533333333555111111111111
11111111111111111111111111111111111111111111333333333333333322211111123333211112333333311111115333555555511111111555511111111553333333333333511111111111
11111111111111111111111111111111111111111155333333333333333211111111112222111111233333355111553333333333355555555333351111115333333333333333311111111111
11111111111111111111111111111111111111111533333333333333332111111111111111111111133333333555333333333333333333333333335555553333333333333333311111111111
11111111111111111111111111111111111111115333333333333333221111111111111111111111133333333333333333333333333333333333333333333333333333333333311111111111
11111111111111111111111111111111111111113333333333333332111111111111111111111111533333333333333333333333333333333333333333333333333333333333311111111111
11111111111111111111111111111111111111113333333333333321111111111111111111111111333333333333333333333333333333333333333333333333333333333333311111111111
11111111111111111111111111111111111111113333333333333311111111111111111111111111333333333333333333333333333333333333333333333333333333333333311111111111
11111111111111111111111111111111111111112333333333333311111111111111111111111111333333333333333333333333333333333333333333333333333333333333211111111111
11111111111111111111111111111111111111111233333333333211111111111111111111111111333333333333333333333333333333333333333333333333333333333333511111111111
11111111111111111111111111111111111111111133333333332111111111111111111111111111333333333333333333333332222222333333333333333333333333333333311111111111
11111111111111111111111111111111111111111533333333331111111111111111111111111111233333333322233333333221111111233333333333333333333333333333351111111111
11111111111111111111111111111111111111111333333333331111111111111111111111111111123333333211123333332111111111133333333333333333333333333333331111111111
11111111111111111111111111111111111111155333333333331111111111111111111111111111113333333111113333321111111111122333333333333333333333333333331111111111
11111111111111111111111111111111111111133333333333331111111111111111111111111111112333332111112233211111111111111333333333333333333333333333335111111111
11111111111111111111111111111111111111133333333333331111111111111111111111111111111333321111111122111111111111111333333333333333333333333333333511111111
11111111111111111111111111111111111111123333333333321111111111111111111111111111111223211111111111111111111111111233333333333333333333333333333311111111
11111111111111111111111111111111111111113333333333311111111111111111111111111111111112111111111111111111111111111123333333333333333333333333333311111111
11111111111111111111111111111111111111112333333333211111111111111111111111111111111111111111111111111111111111111112333222223333333333323333333311111111
11111111111111111111111111111111111111111223333333111111111111111111111111111111111111111111111111111111111111111111222111112233333333312333333211111111
11111111111111111111111111111111111111111112333333511111111111111111111111111111111111111111111111111111111111111111111111111133333333311233332111111111
11111111111111111111111111111111111111111111223333311111111111111111111111111111111111111111111111111111111111111111111111111133333333311122331111111111
11111111111111111111111111111111111111111111113333311111111111111111111111111111111111111111111111111111111111111111111111111133333333311111221111111111
11111111111111111111111111111111111111111111153333355111111111111111111111111111111111111111111111111111111111111111111111111533333333311111111111111111
11111111111111111111111111111111111111111111133333333111111111111111111111111111111111111111111111111111111111111111111111115333333333311111111111111111
11111111111111111111111111111111111111111111133333333511111111111111111111111111111111111111111111111111111111111111111111153333333333211111111111111111
11111111111111111111111111111111111111111111133333333351111111111111111111111111111111111111111111111111111111111111111111133333333333111111111111111111
11111111111111111111111111111111111111111111533333333335511111115511111111111155555555511111111111111111111111111111111111133333333333111111111111111111
11111111155555551111111111111111111111111115333333333333351111153351111111111533333333351111111111111111111111111111111111123333333333511111111111111111
11111115533333335111111111111111111111111113333333333333335111533335111111115333333333335111111111111155511111111111111111112333333333311111111111111111
11111553333333333511111111111111111111111153333333333333333555333333551111153333333333333555111111111533355111111111111111111223333333351111111111111111
11111333333333333355111111111111111111155533333333333333333333333333335515533333333333333333111111111333333511111111111111111113333333331111111111111111
11155333333333333333111111111111115555533333333333333333333333333333333353333333333333333333511111115333333351111111111111111112333333331111111111111111
11133333333333333333511111111115553333333333333333333333333333333333333333333333333333333333311111153333333335551111111111111111233333331111111111111111
11533333333333333333351111115553333333333333333333333333333333333333333333333333333333333333355555533333333333335551111111111111133333331111111111111111
11333333333333333333335115553333333333333333333333333333333333333333333333333333333333333333333333333333333333333331111111111111123333331111111111111111
11333333333333333333333553333333333333333333333333333333333333333333333333333333333333333333333333333333333333333331111111111111113333331111111111111111
11333333333333333333333333333333333333333333333333333333333333333333333333333333333333333333333333333333333333333331111111111111113333331111111111111111
11333333333333333333333333333333333333333333333333333333333333333333333333333333333333333333333333333333333333333335111111111111113333321111111111111111
11333333333333333333333333333222233333332222222222233333333333333333333333333333333333333333333333333333333333333333111111111111113333311111111111111111
11333333333333333333333322232111122223321111111111122222333333333333332223333333333333333333333333333333333333333333511111111111553333311111111111111111
11333333333333333333333211111111111112211111111111111111233333333332221112222233333333333333333333333333333333333333351111111115333333211111111111111111
11333333333333333333332111111111111111111111111111111111122233333221111111111123333222333333333333333333333333333333331111111113333333111111111111111111
11333333333333333333321111111111111111111111111111111111111122322111111111111112332111233333333333333333333333333333335511111553333332111111111111111111
11333333333333333333211111111111111111111111111111111111111111211111111111111111221111122333333333333333333333333333333351115333333331111111111111111111
11233333333333333333111111111111111111111111111111111111111111111111111111111111111111111223333333333333333333333333333335553333332221111111111111111111
11133333333333333332111111111111111111111111111111111111111111111111111111111111111111111113333333333333333333333333333333333333321111111111111111111111
11123333333333333321111111111111111111111111111111111111111111111111111111111111111111111113333333333333333333333333333333333333211111111111111111111111
11112233333333332211111111111111111111111111111111111111111111111111111111111111111111155553333333333333333333333333322333333332111111111111111111111111
11111122333333221111111111111111111111111111111111111111111111111111111111111111111155533333333333333333333333333333211222222221111111111111111111111111
11111111222222111111111111111111111111111111111111111111111111111111111111111111155533333333333333333333333333333333111111111111111111111111111111111111
11111111111111111111111111111111111111111111111111111111111111111111111111111111133333333333333333333333333333333333111111111111111111111111111111111111
11111111111111111111111111111111111111111111111111111111111111111111111111111111533333333333333333333333333333333333111111111111111111111111111111111111
11111111111111111111111111111111111111111111111111111111111111111111111111111111333333333333333333333333333333333332111111111111111111111111111111111111
11111111111111111111111111111111111111111111111111111111111111111111111111111111333333333333333333333333333333333331111111111111111111111111111111111111
11111111111111111111111111111111111111111111111111111111111111111111111111111111333333333333333333333333333333333321111111111111111111111111111111111111
11111111111111111111111111111111111111111111111111111111111111111111111111111111233333333333333333333333333333333311111111111111111111111111111111111111
11111111111111111111111111111111111111111111111111111111111111111111111111111111133333222222333333333333333333333311111111111111111111111111111111111111
11111111111111111111111111111111111111111111111111111111111111111111111111111111123222111111222333333333333333333351111111111111111111111111111111111111
11111111111111111111111111111111111111111111111111111111111111111111111111111111112111111111111233333333333333333335111111111111111111111111111111111111
11111111111111111111111111111111111111111111111111111111111111111111111111111111111111111111111122233333333333333333511111111111111111111111111111111111
11111111111111111111111111111111111111111111111111111111111111111111111111111111111111111111111111123333333333333333311111111111111111111111111111111111
11111111111111111111111111111111111111111111111111111111111111111111111111111111111111111111111111112333333333333333311111111111111111111111111111111111
11111111111111111111111111111111111111111111111111111111111111111111111111111111111111111111111111111233333333333333311111111111111111111111111111111111
11111111111111111111111111111111111111111111111111111111111111111111111111111111111111111111111111111122333333333333311111111111111111111111111111111111
11111111111111111111111111111111111111111111111111111111111111111111111111111111111111111111111111111111333333333333311111111111111111111111111111111111
11111111111111111111111111111111111111111111111111111111111111111111111111111111111111111111111111111111333333333333311111111111111111111111111111111111
11111111111111111111111111111111111111111111111111111111111111111111111111111111111111111111111111111111333333333333351111111111111111111111111111111111
11111111111111111111111111111111111111111111111111111111111111111111111111111111111111111111111111111111333333333333335111111111111111111111111111111111
11111111111111111111111111111111111111111111111111111111111111111111111111111111111111111111111111111111223333333333333111111111111111111111111111111111
11111111111111111111111111111111111111111111111111111111111111111111111111111111111111111111111111111111113333333333333511111111111111111111111111111111
11111111111111111111111111111111111111111111111111111111111111111111111111111111111111111111111111111111113333333333333311111111111111111111111111111111
11111111111111111111111111111111111111111111111111111111111111111111111111111111111111111111111111111111112333333333333311111111111111111111111111111111
11111111111111111111111111111111111111111111111111111111111111111111111111111111111111111111111111111111111333333333333311111111111111111111111111111111
11111111111111111111111111111111111111111111111111111111111111111111111111111111111111111111111111111111111233333333333311111111111111111111111111111111
11111111111111111111111111111111111111111111111111111111111111111111111111111111111111111111111111111111111133333333333311111111111111111111111111111111
11111111111111111111111111111111111111111111111111111111111111111111111111111111111111111111111111111111111133333333333311111111111111111111111111111111
11111111111111111111111111111111111111111111111111111111111111111111111111111111111111111111111111111111111133333333333351111111111111111111111111111111
11111111111111111111111111111111111111111111111111111111111111111111111111111111111111111111111111111111111133333333333331111111111111111111111111111111
11111111111111111111111111111111111111111111111111111111111111111111111111111111111111111111111111111111111133333333333331111111111111111111111111111111
11111111111111111111111111111111111111111111111111111111111111111111111111111111111111111111111111111111111133333333333335111111111111111111111111111111
11111111111111111111111111111111111111111111111111111111111111111111111111111111111111111111111111111111111133333333333333511111111111111111111111111111
11111111111111111111111111111111111111111111111111111111111111111111111111111111111111111111111111111111111133333333333333311111111111111111111111111111
11111111111111111111111111111111111111111111111111111111111111111111111111111111111111111111111111111111111133333333333333351111111111111111111111111111
11111111111111111111111111111111111111111111111111111111111111111111111111111111111111111111111111111111111133333333333333331111111111111111111111111111
11111111111111111111111111111111111111111111111111111111111111111111111111111111111111111111111111111111111123333333333333331111111111111111111111111111
11111111111111111111111111111111111111111111111111111111111111111111111111111111111111111111111111111111111113333333333333331111111111111111111111111111
11111111111111111111111111111111111111111111111111111111111111111111111111111111111111111111111111111111111112333333333333321111111111111111111111111111
11111111111111111111111111111111111111111111111111111111111111111111111111111111111111111111111111111111111111333333333333311111111111111111111111111111
11111111111111111111111111111111111111111111111111111111111111111111111111111111111111111111111111111111111111333333333333211111111111111111111111111111
11111111111111111111111111111111111111111111111111111111111111111111111111111111111111111111111111111111111111333333333333111111111111111111111111111111
11111111111111111111111111111111111111111111111111111111111111111111111111111111111111111111111111111111111111333333333333111111111111111111111111111111
11111111111111111111111111111111111111111111111111111111111111111111111111111111111111111111111111111111111111333333333332111111111111111111111111111111
11111111111111111111111111111111111111111111111111111111111111111111111111111111111111111111111111111111111115333333333331111111111111111111111111111111
11111111111111111111111111111111111111111111111111111111111111111111111111111111111111111111111111111111111153333333333335111111111111111111111111111111
11111111111111111111111111111111111111111111111111111111111111111111111111111111111111111111111111111111111133333333333333511111111111111111111111111111
11111111111111111111111111111111111111111111111111111111111111111111111111111111111111111111111111111111111533333333333333351111111111111111111111111111
11111111111111111111111111111111111111111111111111111111111111111111111111111111111111111111111111111111111333333333333333335111111111111111111111111111
11111111111111111111111111111111111111111111111111111111111111111111111111111111111111111111111111111111111333333333333333333111111111111111111111111111
11111111111111111111111111111111111111111111111111111111111111111111111111111111111111111111111111111111115333333333333333333111111111111111111111111111
11111111111111111111111111111111111111111111111111111111111111111111111111111111111111111111111111111111113333333333333333333111111111111111111111111111
11111111111111111111111111111111111111111111111111111111111111111111111111111111111111111111111111111111113333333333333333333511111111111111111111111111
11111111111111111111111111111111111111111111111111111111111111111111111111111111111111111111111111111111113333333333333333333311111111111111111111111111
11111111111111111111111111111111111111111111111111111111111111111111111111111111111111111111111111111111153333333333333333333311111111111111111111111111
11111111111111111111111111111111111111111111111111111111111111111111111111111111111111111111111111111111133333333333333333333311111111111111111111111111
11111111111111111111111111111111111111111111111111111111111111111111111111111111111111111111111111111111533333333333333333333351111111111111111111111111
11111111111111111111111111111111111111111111111111111111111111111111111111111111111111111111111111111111333333333333333333333331111111111111111111111111
11111111111111111111111111111111111111111111111111111111111111111111111111111111111111111111111111111111333333333333333333333331111111111111111111111111
11111111111111111111111111111111111111111111111111111111111111111111111111111111111111111111111111111111333333333333333333333335111111111111111111111111
11111111111111111111111111111111111111111111111111111111111111111111111111111111111111111111111111111111333333333333333333333333111111111111111111111111
11111111111111111111111111111111111111111111111111111111111111111111111111111111111111111111111111111111333333333333333333333333511111111111111111111111
11111111111111111111111111111111111111111111111111111111111111111111111111111111111111111111111111111111333333333333333333333333311111111111111111111111
11111111111111111111111111111111111111111111111111111111111111111111111111111111111111111111111111111111233333333333333333333333351111111111111111111111
11111111111111111111111111111111111111111111111111111111111111111111111111111111111111111111111111111111133333333333333333333333331111111111111111111111
11111111111111111111111111111111111111111111111111111111111111111111111111111111111111111111111111111111133333333333333333333333331111111111111111111111
11111111111111111111111111111111111111111111111111111111111111111111111111111111111111111111111111111111133333333333333333333333331111111111111111111111
11111111111111111111111111111111111111111111111111111111111111111111111111111111111111111111111111111111133333333333333333333333331111111111111111111111

TRANSITION DATA

LIGHTING DATA
0.5
20 20 40
