30 15
1
111111111111111111111111111111
111111111111111111111111111111
112222222222222222222222222211
112222222222222222222222222211
112222222222222222222222222211
112222222222222222222222222211
112222222222222222222222222211
112222222222222222222222222211
112222222222222222222222222222
112222222222222222222222222222
112222222222222222222222222211
112222222222222222222222222211
112222222222222222222222222211
111111111111111111111111111111
111111111111111111111111111111
30 9 Dungeon 3 9
