30 15
1 3
111111111111111111111111111111
111111111111111111111111111111
113333333333333333333333333311
112222222222222222222222222211
112222222222222222222222222211
112222222222222222222222222211
112222222222222222222222222211
112222222222222222222222222233
112222222222222222222222222222
112222222222222222222222222222
112222222222222222222222222211
112222222222222222222222222211
112222222222222222222222222211
111111111111111111111111111111
111111111111111111111111111111

TRANSITION DATA
30 9 Dungeon 3 9

LIGHTING DATA
0.0
20 20 40
