1111111111111111111111111111111111111111111
1111111111111111111111111111111111111111111
1111111111111111111111111111111111111111111
1111111111111111111111111111111111111111111
1111111111111111111111111111111111111111111
1111111111111111111111111111111111111111111
1111111111111111111111111111111111111111111
1111111111111111111111111111111111111111111
1111111111111111111111111111111111111111111
1111111111111111111111111111111111111111111
1111111111111111111111111111111111111111111
1111111111111111111111111111111111111111111
1111111111111111111111111111111111111111111
1111111111111111111111111111111111111111111
1111111111111111111111111111111111111111111
1111111111111111111111111111111111111111199
1111111111111111111111111111111111111119933
1111111111111111111111111111111111111193333
1111111111111111111111111111111111111133333
1111111111111111111111111111111111111133333
1111111111111111111111111111111111111133333
1111111111111111111111111111111111111133333
1111111111111111111111111111111111111933333
1111111111111111111111111111111111119333333
1111111111111111111111111111111111193333333
1111111111111111111111111111111111133333333
1111111111111111111199999999111111133333333
1111111111111111119933333333999111133333333
1111999911111111993333333333333911123333322
9999333391111119333333333333333311112222211
3333333339999993333333333333333311111111111
3333333333333333333333333333333311111111111
3333333333333333333333333333333311111111111
3333333333333333333333333333333311111111111
3333333333333333333333333333333311111111111
3333333333333333333333333333333211111111111
2333333333333333333333333333333911111111111
1333333333333333333333333333333311111111111
1233333333333333333333333333333391111111111
1133333333333333333333333333333331111111111
1122333333333333333333333333333331111111111
1111333333333333333333333333333339111111111
1111333333333333333333333333333333911111111
1111233333333333333333333333333333311111111
1111123333333333333333333333333333311111111
1111112333222223333333333323333333311111111
1111111222111112233333333312333333211111111
1111111111111111133333333311233332111111111
1111111111111111133333333211122331111111111
1111111111111111133333333911111221111111111
1111111111111111133333333311111111111111111
1111111111111111123333333311111111111111111
1111111111111111113333333311111111111111111
1111111111199111993333333311111111111111111
1111111119933999333333333211111111111111111
1111111113333333333333332111111111111111111
1111111113333333333333321111111111111111111
1111111113333333333333311111111111111111111
1111111112333333333333211111111111111111111
1111111199333333333333111111111111111111111
1111111933333333333333111111111111111111111
1111199333333333333332111111111111111111111
1111933333333333333321111111111111111111111
1119333333333333333211111111111111111111111
1193333333333333222111111111111111111111111
1933333333333222111111111111111111111111111
1333333333322111111111111111111111111111111
9333333333211111111111111111111111111111111
3333333332111111111111111111111111111111111
3333333321111111111111111111111111111111111
3333332211111111111111111111111111111111111
3333331111111111111111111111111111111111111
3332221111111111111111111111111111111111111
2221111111111111111111111111111111111111111
1111111111111111111111111111111111111111111
1111111111111111111111111111111111111111111
1111111111111111111111111111111111111111111
1111111111111111111111111111111111111111111