3434343434343434343434343431122334455667788
4343434343434343434343434341122334455667788
34343434343434343434343434399AABBCCDDEEFFGG
43434343434343434343434343499AABBCCDDEEFFGG
343434343434343434343434343HHIIJJKKLLMM1111
434343434343434343434343434HHIIJJKKLLMM1111
3434343434343434343434343434343434343434343
4343434343434343434343434343434343434343434
3434343434343434343434343434343434343434343
4343434343434343434343434343434343434343434
3434343434343434343434343434343434343434343
4343434343434343434343434343434343434343434
3434343434343434343434343434343434343434343
4343434343434343434343434343434343434343434
3434343434343434343434343434343434343434343
4343434343434343434343434343434343434343434
3434343434343434343434343434343434343434343
4343434343434343434343434343434343434343434
3434343434343434343434343434343434343434343
4343434343434343434343434343434343434343434
3434343434343434343434343434343434343434343
4343434343434343434343434343434343434343434
3434343434343434343434343434343434343434343
4343434343434343434343434343434343434343434
3434343434343434343434343434343434343434343
4343434343434343434343434343434343434343434
3434343434343434343434343434343434343434343
4343434343434343434343434343434343434343434
3434343434343434343434343434343434343434343
BCBCB34343434343434343434343434343434343434
AAAAAB3434343434343434343434343434343434343
222AAAB343434343434343434343434343434343434
22222AAB34343434343434343434343434343434343
111222AAB3434343434343434343434343434343434
222122AAAB343434343434343434343434343434343
2222222AAAB34343434343434343434343434343434
AAA22222AA543434343434343434343434343434343
656AA2222AB34343434343434343434343434343434
3436AA222A543434343434343434343434343434343
43436AA22AB34343434343434343434343434343434
3434CAA22AAB3434343434343434343434343434343
43436AAA22AAB343434343434343434343434343434
343436AAA22AAB343434CBCBCB34343434343434343
4343436AA222AABCBCBCAAAAAABCB34343434343434
34343436AA222AAAAAAAAAA22AAAABCB34343434343
434343436A2222222222222222AAAAAAB3434343434
3434343436AA22222222222222222AAAAB343434343
43434343436AAAAAAAAAAAA22222222AA5434343434
3434343434365656565656AA22211222AB343434343
4343434343434343434CBCAA22111122AAB34343434
343434343434343434CAAAA2221112222AAB3434343
43434343434CBCBCBCAAAA2211111222AAA54343434
3434343434CAAAAAAAAA2221111222AAAA543434343
434343434CAAAA222222222111222AA565434343434
34343434CAAA22211222222222222A5434343434343
4343434CAAA22222222AA22222AAA54343434343434
34343436AA2222AAAAAAAAA2AAAA543434343434343
4343434CAA222AA565656AAAA565434343434343434
34343436AA222A54343436AA5434343434343434343
434343436A222AB3434343654343434343434343434
3434343436A222ABCB3434343434343434343434343
434343434CAA22AAAAB343434343434343434343434
3434343436AA2222AA5434343434343434343434343
43434343436AA222AAB343434343434343434343434
343434CBCB36A2122AAB34343434343434343434343
43434CAAAABCA2122AA543434343434343434343434
34CBCAA2AAAAA2222AAB34343434343434343434343
BCAAAA2222AA2222AAA543434343434343434343434
AAAAA22222222222AA5434343434343434343434343
22222222A222222AA54343434343434343434343434
2222AAAAAAA222AA543434343434343434343434343
2AAAA5656AAAAAA5434343434343434343434343434
AA5654343656AA54343434343434343434343434343
6543434343436543434343434343434343434343434
3434343434343434343434343434343434343434343
4343434343434343434343434343434343434343434
3434343434343434343434343434343434343434343
4343434343434343434343434343434343434343434
